<map>
000000000000000000000000000011050000000000000000000000000000000000000000000000
010101010101010101140000000011050000000000000000040000000000000000000000000000
000000000000000101010000000011050000000000000007110500000000000000000000000000
000000000000000100010000000000000000000000000000060000010101010100000000000000
000000000000000101010000000000000000000000000000000000011111110100000000000000
000000000000000100010000000001000000000000000000000000011111110100000000000000
000000000000000101010000000002000000000000000000000200011111110101010100000000
000000000000000111010500000000000000101100000000000000011111110101010100000000
000000000000000111050000000000000000000100000000000000011111110111110100000001
000000000000000111050000000000000000000101000000000110011111110111110100000001
000000000000000111050000010114000012000106010400000111011111110111110100000001
000000000000000101050000000000000000000000000000000101010101010101010111111101
000000000000000101000000000000000000000011000000000000000000000000000000000000
000000000000000000000000000000000000000000000000000000000000000000000000000000
</map>
<tip>
12345678910111213141516171819202122232425262728293031323334353637383940000
</tip>