<map>
000000000000000000000000000000000000000000000000000000000000000000000000000000000000000000000000000000000000000000000000000000000000000000000000000000000000000000010101010101010101010100000000
000000000000000000000000000000000000000000000000000000000000000000000000000000000000000000000000000000000000000000000000000000000000000000000000000000000000000000010606060606060606060001010000
000000000000000000000000000000000000000000000000000000000000000000000000000000000000000000000000000000000000000000000000000000000000000000000000000001000000000001010000000000000000000000000100
000000000000000000000000000000000000000000000000000000000000000000000000000000000000000000000000000000000000000000000000000000000000000000000000000101010101000100000000000000000000000000000001
000000000000000000000000000000000000000000000000000000000000000000000000000000000000000000000000000000000000000000000000000000000000000000000001010000000001000100000000000000000000000000000001
000000000000000000000000000000000000000000000000000000000000000000000000000000000000000000000000000000000000000000000000000000000000000000010101010001010001000100000000000000000000000000000007
000000000000000000000000000000000000000000000000000000040000000004000000000000000000000000000000000000000000000000000000000000000000040000010101000001010001010100000000000000000001111111111101
000000000000000000000000000000000000000000000000000000010000000001000000000006000000000000000000000000000000000000000400000000000000010000010000000001010000000000010101100101011001000000000000
000000000000000000000000000000000000000000000000010101010101010101010000000000000000000000000300000000000000000000000100000000000000010000000001010001000100000000010000000000000000000000000000
000000000000000000000000000000000000000000000000000000000000000000000100000000000000000000010101010101010101010101010101010101010101010101010101011000000001010110010000000000000000000000000000
000000000000000000000000000000000000000400000001000000000000000000000001000000000000000001010000000000000000000000000000000000000000000000000000000000000000000000000000000000000000000000000000
000000000000000000000000040000000000000100000001000000000000000000000000010000000000000101000000000000000000000000000000000000000000000000000000000000000000000000000000000000000000000000000000
000000000000000000000000010000000000000100000001000000000000000000000000001000000000010100000000000000000000000000000000000000000000000000000000000000000000000000000000000000000000000000000000
000001010101010101010101010101010101010101011001000000000000000000000000000001010101010000000000000000000000000000000000000000000000000000000000000000000000000000000000000000000000000000000000
</map>
<tip>

</tip>