<map>
01010101010101010000000000000000000000000000000000000000000000000000000000000000000000000000000000000000000000000000000000000000000001
01000000000000010000000000000000000000000000000000000000000000000000000000000000000000000000000000000000000000000000000000000000000001
00010000000000010000000000000000000000000000000000000000000000000000000000000000000000000000000000000000000000000000010000000000000001
00000100000000010000000000000000000000000000000000000100000000000000000000000000000000000000000000000000000000000000010000000000000001
00000001000000010000000000000000000000000000000000000100000000000000000000000000000000000000000009000000040000000000010000000000000001
00000000010000010000000000020000000000000000000000000100000000000000000000000000000000000400000009000000010000000000010000000000000001
00000000000101010000000000000000000000000000000000000100000000000000000000000004000000000100000009000000010000000000010000000000000001
00000000000101010101000000000000000000000000000000000000000000000000040000000001010101010101010101010101011010101010011111111111111101
00000000010101010101010101010112010000010101011400000000001201010101010101010101010101010101010101010101010101010101010000000000000000
00000000010101000000000000000000010000010000000000000000000001010101010000000000000000000000000000000101010101000000000000000000000000
00000000010100000000000000000000010101010000000000000000000000010101000000000000000000000000000000000001010100000000000000000000000000
00000000010100000000000000000000000000000000000000000000000000010101000000000000000000000000000000000001010100000000000000000000000000
00000000010100000000000000000000000000000000000000000000000001010101010000000000000000000000000000000101010101000000000000000000000000
00000000010100000000000000000000000000000000000000000000000101010101010100000000000000000000000000010101010101010000000000000000000000
</map>
<tip>
Dale click para saltar
</tip>
