<map>
000000000000000000000000010000000000000001000000000000000000000000000000000001010101010000000000150001010101010101010101010000000000000000000000000000000701090908080809090908080809090908080809090900000101010100000000000000000000000000010100000000000000000000000000000101010101010101010101010101010101010000010500000000001400000000000000000000
000000000000000000000001030100000000000103010000000000000000000000000000000001060606010000000000150001000000000000000000010101000000000000000000000000000701090808080909090808080909090808080909090101010101080101010100000000000000000001010000000000000000000000000000000006060606060600000000000000000007010000010500000000001400000000000000000000
000000000000000000000103140301000000010314030100000000000000000000000101010101051107010001000000150101000000000000000000000001010000000000000000000000000701080808090909080808090909080808090101010101010108080808080101000000000000000101000000000000000000000000000000000000000000000000000000000000000007010000010500000000001400000000000000000000
000000000000000000010314081403010001031408140301000000000000000000000106060601051107010001010000031414141400000000000000000000010100000000000000000000000701080809090908080809090908080809090101010108080808080808080801010000000000010100000000000000000000000000000000000000000000000000000000000000000007010000010500000000001400000000000000000000
000000000000000001031408060814030103140806081403010000000000000101010105110701051107010000010000000000000000000000000000000000000100000000000000000000000701080909090808080909090808080909010101080809090909090909090908010100000001010000000000000000000000000000000000000000000000000000000000000000000007010000010500000000001400000000000000000000
000000000000000103140806090608140314080609060814030100000000000106060105110701051107010000010000000000000000000000000000000000000100000000000000000000000701090909080808090909080808090901010808090909090908080808080908080101000101000000000000000000000000000004000000000000000000000000000400000000000000000000010500001400001400001400000000000000
000000000000010314080609110906081408060911090608140301000000010105070105110701051107010000010000000000000000121212121203000000000000000000000000000101010101010101010101010101010101010101080909090909080808010101080909090801010100000000000000000004000000000006000000000000000000000000000600000000000000010000000000000014001400140000000000000000
000000000000010312080409110904081208040911090408120301000000010105070105110701051107010000010100000000000000000000010113000000000000000000000000010312031403120314030101010100000001010101090909090808010101010001010808080808000000000004000000000006000000000004000000000000000000000000000401010101010000010001010000000000141414000000150000000000
000000000000000103120804090408120312080409040812030100000000000104040105110701051107010000000100000000000000000001010113000000000000000000000001031203140312031403010100000000000000000101090908080801010000000000010101010101010101010101010101010101010101010101010101010101100101010101010601000000010000010007010000000000001400000015000000000000
000000000000000001031208040812030103120804081203010000000000000101010105110701051107010000000101000000000000000101000013000000010101010100000103120314031203140301010000010101000101000000090808010101000000000000000000000000000000000000000000000000000000000000000000000000000000000000010101000000010000010007010000000000000000001500000000000000
000000000000000000010312081203010001031208120301000000000000000000000104040401051107010000000001010000000001010100000013000000010801110100010312031403120314030101000000010001000101010101080801010100000000000000000000000000000000000000000000000000000000000000000000000000000000000000000000000000010000010007010000000000000900151515151515151515
000000000000000000000103120301000000010312030100000000000000000000000101010101051107010000000000010101011001000000000013000000010801010101031203140312031403010100000000010001000100000001010101000000000000000000000000000000000000000000000000000000000000000000000000000000000000000000000000000000010000010007010000000000000000001500000000000000
000000000000000000000001030100000000000103010000000000000000000000000000000001040404010000000000000000000000000000000000000000010108080101120314031203140308030000000000010001110100000000000000000000000000000000000000000000000000000000000000000000000000000000000000000000000000000000000000000000010000010007010000000000000000000015000000000000
000000000000000000000000010000000000000001000000000000000000000000000000000001010101010000000000000000000000000000000000000000030101010101010101010101010101010101010110010001010100000000000000000000000000000000000000000000000000000000000000000000000000000000000000000000000000000000000000000000010000010007010000000000000000000000150000000000
</map>
<tip>

</tip>