<map>
0000000000000000000000000000000000000000000000000000000000000000000000000000000000000000000000000000000000000000000000000000000000000000000000000000000000000000000000000000000000000000000000000000000000000000000000000000001100
0000000000000000000000000000000000000000000000000000000000000000000000000000000000000000000000000000000000000000000000000000000000000000000000001300000000000000000000000000000000000000000000000000000000000000000000000000001100
0000000000000000000000000000000000000000000000000000000000000000000000000000000000000000000000000000000000000000000000000000000000000000000000000000000000000000000000000000000000000000000000000000000000000000000000000000001100
0000000000000000000000000000000000000113011301130101010000000000000000000000000000000000000000000000000000000000000000000000000000000000000000000000000000000000000000000000000000000000000000000000000000000000000000000000001100
0000000000000000000000000000000000000106010601060101010000000000000000000000000000000000000000000000000000000000000000000000000000000000040000000000000000000000000015151500000000000000000000000000000000000000000000000000001100
0000000000000000000000000000000000000100010001000101010000000000000000000000000000000000000000000000040000000000000000000000000000000000010500000000000000000000000000000000000000020002000000000000000000000000000000000000001100
0000000000000000000000000000000000000100010000000000010000000000000000000000000000000000000000000007090500000101011010100000000001010100060000000000000000000000000000000000000000000000000000000000000000000000000000000000001100
0013001300000000000000000000000000000100000001000100000000000000040000000000000000000004040101010101010101010101131313010404040401131300000000000000000000000000000000000000000000000000000000000000000000000000000000000000001100
0000000000000000000000000000000000000000010001000101010001000100010001000100010101010109090901130000000000000000000000010101010101130101010101010100000101010101010100000000000004040404040000000000000000000000000000020000001100
0404040404040404040400000000000000000100010401040101010000000000000000000000000000000101010101000000000000000000000000000000000000000000000000010509090901010000000101010100000000000000000000000000000000000000000000000000001100
0101010101010101010101010101010101010113011301130101010000000003000000030000000000000000000000000000000000000000000000000000000000000000000000010509090901010000000000011300000000000000000000000000000000000000000000000000001100
0000000000000000000000000000000000000000000000000000000000000000000000000000000000000000000000000000000000000000000000000000000000000000000000010509090907010000000000011300000000000000000000000000000000000000000000000000001100
0000000000000000000000000000000000000000000000000000000000000004040404040000000000000000000000000000000000000000000000000000000000000000000000010509090907010000000000011313000000000000000000000001010101040404010101040111111100
0000000000000000000000000000000000000000000000000000000000000000000000000000000000000000000000000000000000000000000000000000000000000000000000010104110401010000000000010101010101010101010101010101010101010101010100000000000000
</map>
<tip>
THANKS FOR PLAYNG!
</tip>