<map>
0000000000000000000000000000000000000000000000000000000000000000000000000000000003000000000000000000000000000000000000000000000000000000000000000000000000000000000000000000000000000000000000000000
0000000000000000000000000000000000000000000000000000000000000000000000000000000001000000000000000000000000000000000000000000000000000000000000000000000000000000000000000000000000000000000000000000
0000000000000000000000000000000000000000000000000000000000000000000000000000000101000100000000000000000000000000000000000000000000000000000000000000000000000000000000000000000000000000000000000000
0000000000000000000000000000000000000000000000000000000000000000000000000000010101000100010000000000000000000000000000000000000000000000000000000000000000000000000000000000000000000000000000000000
0000000000000000000000000000000000000000000000000000000000000000000000000001010101010101010000000000000000000000000000000000000000000000000000000000000000000000000000000000000000000000000000000000
0000000000000000000000000000000000000000000000000000000000000000000000000101010101000100010000000000000000000000000001010000000000000000000000000000000000000000000000000000000000000000000000000000
0000000000000000000000000000000000000000000000000000000000000000000000010101010101000100010000000000000000000000000000000000000101000000000000000000000000010000040000000000000000000000000000000000
0101010100000000000000000000000000000000000000000000000000000000000001010101010101000100010000010100000101000001010000010100000000000000000000000000000000010001010100000000000000000000000000000000
0000000000000000000000000000010001010100000000000000000000000000000001010101010101000100010000000000000000000000000000000000000101000000010101010101010000010001000000000100000000000000000000000000
0000000000000101010000000000000001010100000000000000000000000000000001010101010101000100010000000101000000000001010000000000000000000000000000000000000000010001000000000000000000000000000000000000
0000000000000101010000010101000001010100000000000000000000000000000001010101010101000100010000000000000001010000000000010100000001010000000000000000000000010001000000000000010000000000010001000001
0000000000000000000000010101000000000000000000040000000004000010000001010101010101000100010000000101010100000000000000000000010000000000000000000000000000011101000000000000000000000100000001111101
0000000000000000000000010101000000000000010101010101010101010101010101010101010101010101010100000000000101000001010000010100000100000000000000000000000000010101000000000000000001000000000001010101
0000000000000000000000000000000000000000000000000000000000000000000000000000000000000100000000000101000000000000000000000000000000000000000000000000000000000000000000000000000000000000000000000000
</map>
<tip>

</tip>