<map>
00000000000000000000000000000000000000000000000000001414140000000000000000000000000000000000000000000000000000000000
00000000000000000000000000000000000000000000000000000000000100000000000000000000000000000000000000000000000000000000
00000000000000000000000000000000000000000000000000000000000500000000000000000000000000000000000000000000000000000000
00000000000000000000000000000000000000000000000000000000001301000000000000000000000000000000000000000000000000000000
00000000000000000000000000000000000000000000000000000000000005000000000000000000000000000000000000000000000000000000
00000000000000000000000000000000000000001000000000000004000013010000000000000001010101010101000000000000000000000000
00000000000000000001010106100404040404040404040404040410040404041300000000000000000000000000010000000000000000000000
00000000000000120001010100000000000000000000000000000000000000000101010112010101010101000000000100000000000000000000
00000604040404040406000000000000000000000000000000000000000000000000000000000000000000010000000000000000000000000007
00000606060606060606000000000000000000000000000000000000000000000000000000000000000000000100000000001111111111111107
00000606060606060606000000000000000000000000000000000000000000000000000000000000000000000001000000000000000000000007
00000000000000000000000000000000000000000000000000000000000000000000000000000000000000000000010000000000000000000007
00000000000000000000000000000000000000000000000000000000000000000000000000000000000000000000000100000000000000000007
00000000000000000000000000000000000000000000000000000000000000000000000000000000000000000000000001040404040404040400
</map>
<tip>

</tip>