<map>
0000000000000000000000000000000000000000000000000000000004040404000000000000000000000000000000000000000000000000000000000000000000000000000000000000000000000000000000000000000101000000000000000000000000000000000000000000000000000000000404040400000000000101010101010100000000000000000000000000000000000000000000000000000000000000000000000000000000000000000000000000000000000000000000000000000000000000000000000000000000000000000000000000000000000000000000000000000000000000000000000000000000000000000000000000000001000000000000000000000001000000000000000000000000000000000000000000000000000000000000000000000000000000000000000000000000000000
0101010001000100010101000101010001010100010101000000000001010101000000000000000000000000000000000000010101010101010101010101010201010000000100000000000100000000000000000000000000000000000000000000000001000000000101000000000000000000000101010104040400000108080808080100000000000000000001010101010101010101010101010101010101010101010101010101010000000000000000000000000000000000000000000000000000000000000000000000000000000000000000000000000000000001000001000001000001000001010101010100000000000000000000000000000001000000000000000000000001000000000000000000000000000000000000000000000000000000000000000000000000000101010101010101010101010100
0100000001000100010001000100000001000100000100000000000001000000000000000000000000000000000000010101010606060600000001000000000000010000000000000000000000000000000100000000000000000000000001000000000000000000000000000001010000000000010101010101010101010108010101080100000000000000000001060606060106060606060601000000000000010000000000011111010000000000000000000000000000000101000000000000000000000000000000000000000000000000000000000000000000000000000000000000000000000000000000000100000000000000000000000000000001000000000000000000000001000000000000000000040000000000040000000000040000000000000000000000000000000101010101010101010000000100
0101000000010000010101000101000001010000000100000000000001000000000000010000000000000000000000000000000000000000000006000000000000010000000000000000000000000000000000000000000000000000000001040404040404040400000001000000000000010100000909090909080808080808010101080100000000000000000001000000000100000000000001000000000000010000000000011111010000000000000000000000000000000101000000000000000000000000000000000000000000000000000000000000000000000000000000000000000000000000000000000100000000000000000300000000000001000000000000000000000001000000000000000007010500000007010500000007010500000000000000000000000000000101010101010101010000000100
0100000001000100010000000100000001000100000100000000000000000000000000010001000000000000000101000000000000000000000000000000000000010404040404040404040404040404040404040404040404040404040401010101010101010100000001000000010000000000000101010109010101010110010201080100000000000000000001000000000100000000000000000000000000010000000000011111010000000000000000000000000000000101000000000000000000000000000000000001010101010000000000000000000000000001000001000001000001000001000000000100000000000000000101000000001401010101010101010101010801000000000400000000060000000000060000000000060000000000000000000000000000000113121514131214150000000100
0101010001000100010000000101010001000100000100000000000001000000000000000001000000000000000000000000000000000000000000000000000101010101010101010101010101010101010101010101010101010101010101010000000000000104040401040404010000000100000101010109090909090909090901080100000000000000000001000000000000000000000000000000000000010000000000011111010000000000000000000000000000000101000000000000000000000000000000000001000000010000000000000000000000000000000000000000000000000000000000000100000000000000000100000000000101010101010101010101010801000000070105000000000000000004000000000000000000000000040000000000000000000000000000000000000000000100
0000000000000000000000000000000000000000000000000000000001000000000001000000000100000001010000000000000010000000000004000000000000090300000000000000000000000000000000000000000000000000000000000001010101080101010101010101011010010101010101010101010101010101010101080100000000000000000001000000000000000000000000000000000000010000000000011111010000000000000001010000010101010101010101010101010101010000000000000101000001010000000000000000000000000000000000000000000000000000000000000100000000000000000100000000000000000000000000000000010801000000000600000000000000000701050000000000000000000000010500000000000000000110101010101010101111110100
0000000000000000000000000000000000000000000000000000000001000000000001000000000100000000000000000000000001000000000001010100000001010101000000000101000000000001010001000100010001000000000101010101000001080100000000000000000000000000000000000000000000000000000000000000000000000200000000000000000000000000000001010101010000000000000000011111010000000000000001010000010606010101010101010101010101010000000000000100000001000000000000000000000000000001000001000001000001000001000000000100000000000000010100000000000000000000000000000000010801000000000000000000000000000006000000000000000000000000060000000000000101010101010101010101011111110100
0000000000000000000000000000000000000000000000000000000001000000000001000000000000010000000000000000000001000000000001000000000000000000000000000000000000000000000000000000000000000000000000000000000001080100000000000000000000000000000000000000000000000000000000000000000000000000000000000000070100000000000000000000010401000100000000010101010000000000000001010000000000000000000000000000000000010000000000000100000001000000000000000000000000000000000000000000000000000000000000000100000000000000010000000000000004040404000000000000010801000000000000000000000000000000000000000000000000000000000000000000000101010101010101010101010101010100
0000000000000000000000000000000000000000000000000000000001000000000100000000000000010001010101010101010101010101010101000000000000000000000000000000000000000000000000000000000000000000000000000000000001080100000200000000000000000000000000000000000000000000000000000000000000000000000000000000070100000000000000000000010101000104040404010000000000000000010101010000000000000000000000000000000000000000000000010100000001000000000000000000000000000000000000000000000000000000000000000100000000000000010000000000000001010101000000000000010801000000000000000000000000000000000000000000000000000000000000000000000000000000000000000000000000000000
0000000000000000000000000000000000000000000000000000000001010101010100000000000000000001000000000000000000000000000000000000000000000000000000000000000000000000000000000000000000000000000000000000000001080100000000000000000000000000000000000000000000000000000000000003000000000000000001000000070100000000000000000000010101000101010101010000000000000000010101010101010101010000000000000000000000010000000000010000000001000000000000000000000000000001000001000001000001000001000000000100000000000001010000000000000000000009000000000000010803000000000000010101010101010101010101010101010101010101010101010101010101050101010501010105010105000000
0000000000000000000000000000000000000000000000000000000000000000000000000000000000000000000000000000000000000000000000000000000000000000000000000000000000000000000000000000000000000000000000000000000001080800000000000000000000000000000000000000000000000000000001010101010101010101010101000000070100000000000001010100010101000000000000000000000000000000010101010101010101010000000000000000000000010000000000010000000001010000000000000000000000000000000000000000000000000000000000000100000000000001000000000000000001010101000000000000010101010101010000060000000000000000000000000000000000060600000000060000010500000100010501000105010001050000
0000000000000000000000000000000000000000000000000000000000000000000000000000000000000000000000000000000000000000000000000000000000000000000000000000000000000000000000000000000000000000000000000000000001010101010101011300000000000100000000000100000000000100000000000000000000000000000001000000070104040404040401000100010101010101010101010101010101010101010101010101010101010401040101010401010101010101010101010000000000010101010101000000000000000000000000000000000000000000000000000100000000000001000000000000000006060606000000000000000000000000000000000000000000000000000105000000010500000000000000000000010501050100010501000105010001050000
0000000000000000000000000000000000000000000000000000000000000000000000000000000000000000000000000000000000000000000000000000000000000000000000000000000000000000000000000000000000000000000000000000000001010101010101010100000000000800000000000800000000000800000000000000000000000000000001010101010101010101010101000100010000000000000000000000000000000000000000000000000000000000000000000000000000000000000000000000000000000000000001010101010101000001000001000001000001000001000000000101010101010101000000000000000000000000000000000000000000000000000000000000000000000000000600000000060000000000000000000000010101050101010501010105010105000000
</map>
<tip>
CASI
</tip>
