<map>
00000000000000000000000000000000000000000000000000000000000000000000000000000000000000000000000000000000000000000000000000000000000000000000000000000000000000000000000000000000000701000000000000000000000000000000000000000000000000000000000000000000000000000000000000000000000000000000000000000000000000000000000000000000000000000000000000000000000000000000000001010101010100000000000000000000000000000000000000000000000000000000000000000000001100
00000000000000000000000000000000000000000000000000000000000000000000000000000000000000000000000000000000000000000000000000000000000000000000000000000000000000000000000000000000000701000000000100000000000000000000000001010101010100000101010000000000000000000000000000000000000000000000000000000000000000000000000000000000000000000000000000000000000000000000000001010101010100000000000000000000000000000000000101010500000701000000000000000000001100
00000000000000000000000000000000000000000000000000000000000000000000000000000000000004040404040404040404040400000012121200000000000000000000000000000000000000000000000000000000000701000000000000000000000101010000000001010101010100000101010000000000000000000000000000000000000000000000000000000000000000000000000000000000000001010101010101010101010100000000000000000000000000000000000000000000000010101005000101010500000701000000000000000000001111
00000000000000000000000000000000000000000000000000000000000000000000000000000000000001010101010101010101010100000008080801010101010500000001010101000000000000000000000000000000000701010100000101010101010100010000000001010101010100000101010000000000000000000000000000000000000000000000000000000000000000000000000000000000000000000000000000000000000000000000000000000000000000000000000000000000101001010101000101010500000000000000000000000000000011
00000000000000000000000000000000000000000000000000000000000000000000000000000000000000000600000000060000000600000000000000000102010500000001050001010101010114000000140101010101010101060600000100000000000000010000000001010101010101010101010000000000000000000000000000000000000000000000000000000000000000000000000000000100000000000000000000000000000000000000000100000000000000010000000000001010000701050000000000010500000000000000000000000000000011
00000000000000000000000000000000000000000000000000000000000000000000000000000002020000000000000000000000000000000000000000000000010500000001050000000000000000000000000000000000000000000000000100000000000000010000000001010101010101010101010000000000000000000000000000000000000000000000000000000000000000000000000000000100000000000000000000000000000000000000000101010101010100010000000000000106000701050000000000010500000000000000000000000000000011
00000000000000000000000000000000000000000000000000000000000004000000000000000000000009000009000400000010000000000000040000000000060000000001050000000000000000000000000000000000000000000000000100000000000000010000000000001303150000000001010000000000000000010101000000000000000000000000000000000000000000000000000000000100000000000000010100000001010101060606060600000000000000010000000710100100000701050000000000010500000000000000000000000000000011
00000000000000000000000000000101010110100000010101011010101001040400000000000000010101010101010101010106010101010101010010000000000000000001050001050000000000000000000000000000000000000000000100000000000000010000000000000000000000000001010112121213131313131313131313131313131301010000000000000000000000000000000000000100000000000000010100000000000000000000001515121215131300010101010106060101010101050000000000010500000000000000000000000000000011
00000000000000000000000000000000000404040404040401010101010101010101010101010101010100060606060606060600010106000000000001010101010112101201010101050000000000000000000000000000000000000000000100000000000000010101010101010000100110000000000000000000000000000000000000000000000000010000000000000000000000000000000000000100000000000000060600000000000000000000000000000000000000000000000600000600000000000000000000010500000101010101111111111111111111
00000000090909090909090900000101010101010101010105060606060606060606060606060606060600000000000000000000010104040404040401000000000000000000000000000000000000000000000000000000000000000000000100000000000000000000000001010101010101010101101010101010101010101010101010101010100100010101010101010101010101010101010100000101010101010100000000000000000701010101011010101010101000000000000000000000000000000000000000010500000101000701000000000000000000
00000000010101010101010100000606060606060606070105000000000000000000000000000000000000000000000000000000010101010101010101000000000000000000000000000000000000000000000000000000000000000000100100000000000000000000000000000000000000000000000000000000000000000000000000000000000100000000000000000000000000000000000000000000000000000000000000000000010101000000000000000000000000000101010101010101010101010101000000010500000101000701000000000000000000
00000000000000000000000004040404040000000000000600000000000000000000000000000000000000000000000000000000000000000000000000000000000000000000000000000000010101010101010101000001010101010101010100000000000000000000000000000000000000000000000000000000000000000000000000000000000110101010101010101010101010101010101001010101010101010101010101101001010101000000000000000000000000000000000600000600000000000001000000140000000101000701000000000000000000
00000404040404040404040101010101010500000000000000000000000000000000000000000000000000000000000000000000000000000000000000000000000000000000000000000000000000000000000001040401000000000000000000000000000000000000000000000000000000000000000000000000000000000000000000000000000000000000000000000000000000000000000000000000000000000000000000010100010101000000000000000000000000000000000000000000000000000000010000000000000100000701000000000000000000
00000101010101010101010106060606060000000000000000000000000000000000000000000000000000000000000000000000000000000000000000000000000000000000000000000000000000000000000001010101000000000000000000000000000000000000000000000000000000000000000000000000000000000000000000000000000000000000000000000000000000000000000000000000000000000000000000000000000000000000000000000000000000000000000000000000000000000000000101011111111101010101000000000000000000
</map>
<tip>
Si no te lo pasas...
</tip>
