<map>
000000000000000000000000000000000000000000000000000000000000000000000000000000000000000000000000000000000000000000000000000000000000000000000000000000000000000000000000000000
000000000000000000000000000000000000000000000000010000000000000000000000000000000000000000000000000000000000000000000000000000000000000000000000000000000000000000000000000000
000000000000000000000000000000000101000000000001010100000001000000000000000000000000000000000000000000000000000000000000000000000000000000000000000000000000000000000000000000
000000000000000000010000000000010101010000000001010004010400040100000000000000000000000000000001010000000000000000000000000000000000000000000000000000000000000000000000000000
000000010100010101000001010000010000000101010101010100000000000004010000000000000000000000010100010101000000000000000000000000000000000000000000000000000000000000000000000000
000001010101010000000000000001010100000000000000000000000000000000010101000000000000000101010000000001000000000000000000000000000000000000000000000000000000000000000000000000
000101000000000000000000000000010000000000000000000000000000000000000000010101010101010100000000000000010101010100000000000101010101000001010000000000000000000000000000000000
110101000000000000000000000000000000000000000000000000000000000000000000000000000000000000000000000000000000000101010101010000000000000000000101010101010101010100000000000000
000000000000000000000000000000000000000000000000000000000000000000000000010101000000000000000000000000000000000000000000000000000000000000000000000000000000000001000000000000
000000000000000000000000000000000000000000000000000000000001010100000000000100000000000000000000000000000000000000000100010000000000000000000000000000000000000000010100000000
010101010101010101010101010101010101010101010101010101010101000101000001000000010101000000000000000000000000000001010100000101000101010000000000000000000000010000000401000000
010606060606060606060606060606060606060606060606060606010100000001010101010001000001010101010100000000000001010101000000000001010100000001000000010101010101010000011101000000
010000000000000000000000000000000000000000000000000000010000000000000000010101000000000101010100000000000000000000000000000000000000000000010100000000000000000000010101010100
010101010101010101010101010101010101010101010101010101010101010101010101010000000000000000000101040404101000000000000000000000000000000000000000000000000000000012010000000000
</map>
<tip>
never going to wi
</tip>