<map>
000000000000000000000000000001010000000000000000000000000004040404000000000000000000000000000000040404000000000000000000000000000000040401010404040000000000000000000000000000000000000000000000000000000000000000000000000000000000000004000000000000000000000000000000000006000000000000000000000000000000000000000000000600000000000000000000060000000000000000000006000000000000000000000000000000000000000000000101010101010101010101010101010101010101010101010101010101010101
000000000000000000000000000001010000000000000000000000000401010101040400000000000000000000000004010101000000000000000000000000000000060601010101010400000000000004040000000000000000000000000000000000000000000000000000000000000000000001000000000000000000000000000000000000000000000000000006000000000006000000000000000000000000060000000000000000000006000000000000000000000000060000000000000600000000000000000101010101010101010101010101010101010101010101010101010101010101
000000000000000000000000000001010000000000000000000000000101010101010104000000000000000000000401010106000000000000000000000000000000000006060101010104040404040401060000000000000600000000000000000001000000000600000000000006000000000001000006000000000000000000000000000000000000000000000000000000000000000000000000000000000000000000000000000000000000000000000000000000000000000000000000000000000000000000000101010101010101010101010101010101010101010101010101010101010101
000000000000000000000000000012130000000000000000000000000606010101010101040404040404040000040101010600000000000000000000000000000000000000000606010101010101010101000000000000000000000000000000000001000000000000000000000000000000000001000000000000000000000000000000000000000006000000000000000000000000000000000000000000000000000000000000000000000000000000000000000000000000000000000000000000000000000000000101010101010101010101010101010101010101010101010101010101010101
000000000000000000000000000000000000000000000000000000000000060101010101010101010101010404010101060000000000000000000000000000000000000000000000060601010101010606000000000000000000000000000000000000000000000000000000000000000000000001000000000000000000010000000000000000000000000000000000000000000000000000000000000000000000000000000000000000000000000000000000000000000000000000000000000000000000000000000101010101010101010101010101010101010101010101010101010101010101
010101010101010101010101010110100101010101010101000000000000000606010101010101010606060606060101000000000000000000000000000004040400000000000000000006010101010000000000000000000000000000000000000000000000000000000000000000000000000006000000000000000000010000000000060000000000000000000000000000000000000000000000000000000000000000000000000000000000000000000000000000000000000000000000000000000000000000000000000000000000000000000000000000000000111111111111010101010101
010101010101010101010101010101010101010101010101000000000000000000060101010106060000000000000606000000000000000000000000040401010104040000000000000000060101010000000006000000000000000000000000000600000000000006000000000000000000000000000000000000000000000000000000000000000000000000000000000000000000000000000000000000000000000000000000000000000000000000000000000000000000000000000000000000000000000000000000000000000000000000000000000000000000000000000011010101010101
060101010101010101010101010101010101010101010101000000000000000000000601010600000000000000000000000000000000000000000404010101060101010400000000000000000101010000000000000000000000000000000000000000000000000000000000000000000001000000000000000100000000000000000000000000000000000001000000000006000000000001000000000001000000000001000000000001000000000001000000000001000000000001000000000001000000000106011010101000101010101010101010101010101010111111111111010101010101
000601010101010101010101010101010101010101010606000000000000000000000001060000000000000000000000000000000000000004040101010106000606010104000000000000000101010000000000000000000000000000000000000000000000000000000000000000000001000000000000000100000000000000000000000000000000000001000000000001000000000001000000000001000000000001000000000001000000000001000000000001000000000001000000000001000000000000000101010100010101010101010101010101010101010101010101010101010101
000001010101010101010101010101010101010101060000000000000000000000000006000000000000040400000000000000000000000001010101010600000000010101040000000000000114010000000000000000000000000000000000000000000000000000000000000000000000000000000000000000000600000000000000000000000000000000000000000000000000000000000000000000000000000000000000000000000000000000000000000000000000000000000000000000000000000000000000000000010101010101010101010101010101010101010101010101010101
000006060101010101010101010101010101010106000000000000000000000000000000000000000404010104000000000000000000040401010101060000000000060606010400000000000000000000000001000000000000000000060000000000000000000000000000010000000000000001000000000000000000000000000000000000010000000000000000000000000000000000000000000000000000000000000000000006000000000000000000000000000000000000000000060000000000000000000101010101010101010101010101010101010101010101010101010101010101
000000000601010101010606010101010101010600000000000000000000000000000000000000040101060601040400000010100000010101060606000000000000000000060101010101010110010111111101000000000000000000000000000000000000000000000000010000000600000001000000060000000000000000000000000000010000000006000000000000000000000000000000000000000000000000000000000000000000000600000000000000000000000000000000060000000006000000000101010101010101010101010101010101010101010101010101010101010101
000000000006060101060000060101010101060000000000000000000000000000000101010101010606000006060604040401010404010606000000000000000000000000000606060101010101010101010106000000000000060000000000000000060000000100000000000000000000000000000000000000000000000000000100000000000000000000000000060000000000000000000000000000000000000000000000000000000000000000000000000000000000000000000000060000000001000000000101010101010101010101010101010101010101010101010101010101010101
000000000000000606000000000606060606000000000000000000000000000000000601010106060000000000000001010101010101060000000000000000000000000000000000000606060606060606060600000000000000000000000000000000000000000100000000000000000000000000000000000000000000000000000100000006000000000000000000000000000006060606000006060600000006060606060000060606060606060606060600000606060000060606060606060000000000000000000101010101010101010101010101010101010101010101010101010101010101
</map>
<tip>

</tip>