<map>
000000000000000000000000000000000000000000000000000000000000000000000000000000000000000000000000000000000000000000000000000000000000000000000000000000000000000000000000000000000000000000000000000000000000000000000000000000
000000000000000000000000000000000000000000000000000000000000000000000000000000000000000000000000000000000000000000000000000000000000000000000000000000000000000000000000000000000000000000000000000000000000000000000000000000
000000000000000000000000000000000000000000000010000000000000000000000000000000000000000000000000000000000000000000000000000000000000000000000000010000000000000000000000000000000000000000000000000000000000000000000000000000
000000000000000000000013000000000000000000000001000000000000000000000000000000000000000000000000000000000000000000000000000000000000000000000000000000000000000000000000000000000000000000000000000000000000000000000000000000
000000000000000000000000000000000000000000000000000000000000000000000000000000000000001400000000000000000000000000000000000000000000000000000000000000000000000000000000000000000000000000000000000000000000000000000000000000
000000000000000000000000000000000000000000120000000000000000000000000000000000000000000000000000000000000000040404000000000000000000000000000000000000000000000000000000000000000000000000000000000000000000000000000000000000
000000000000000000000000000101010000000000000000000000000000000000000000000000000000000000000004040404000000010101000000000000000000000000000000000000000000000000000000000000000000000000000000000000000000000000000000000000
000000000000000000000000000000000000100000000000000000000000000000000000000000000000000000040401010101000000000000000000000000000000000000000000000000000000000000000000000000000000000000000000000000000000000000000000000000
000000040004000400000000000004040000010000000000000000000000010101000000000000010101010000010101000000000000000000000000000000000000000400000000010101000000000000000000000000040404040404040404040404040404040404040404040404
000000010001000100010100000001010000000000000000000000000000010101000000000000010101010000000000000000000000000101010000000000000000000100000000000000000000000404010101010101111111111111111111111111111111111111111111111111
000000010001000100010100000000000000000000000000000000000000000000000001010000000000000000000000000101010100000101010000000900000000000100000000000101010101000101010000000000000000000000000000000000000000000000000000000000
000000010001000100000000000000000000000000000000000000000000000000000001010000000000000001010000000101010100000000000001010101010101010101010101010101010100000000000000000000000000000000000000000000000000000000000000000000
000000000000000000000000000000000000000000000000000000000000000000000000000000000000000001010000000000000000000000000001010101010101010101010101010101010100000000000000000000000000000000000000000000000000000000000000000000
000000000000000000000000000000000000000000000000000000000000000000000000000000000000000000000000000000000000000000000000000000000000000000000000000000000000000000000000000000000000000000000000000000000000000000000000000000
</map>
<tip>

</tip>
