<map>
0000000000000000040404040404010101010101010101010101000000000000000000000000000006060606000000000000000000000000000000000000000000000000000000000000000000000000000000000000000000000000000000
0000000000000000070100000004010606060606060606060601000000000000000000000000000000000000000000000000000000000000000000000000010000000000000000000000000000000000000000000000000000000000000000
0000000000000000000100000001010000000000000000000001000000000000000000000000000000000000000000000000000000000000000000000000010101010101010101000000000000000000000000000000000000000000000000
0000000101000000000100000000000000000000000000000001010101010101000000000000000010000000000000000000000000000000000000000000000000000000000701010101010101010101010101010101010000000000000000
0000000105000100000100000000000000000000000000000000000000000000000000000000000000000000000000000000000000000000000000000000000000000000000701111111111111111111111101000000000001010101010101
0000000105000100000100000000000000000001000000000000000000000001000000000000010000000000000000000000000000000000000000000000010101010101010101010111111111111111111101000000000001000000000001
0000000105000000000100040000000000000000000000010101010101010101000000000000010000000000000000000000000000000000000001000000000000000000000000000101010101010101010101000000000000000000000001
0000000105000000000000010101010101010000000000000000000000000007000000000101010000000000000000000000000000000000000100000000000001010101010101000006060606060606060606000000000101000000000001
0000000105000000000000010000000000000000000000000010001000000007000000000000000000000000000000000000000000000000010000000101010101000000000001000000000000000000000000000000000101000000001101
0000000101010100000110010000000000000000000000000001000100000007000000000000000000000000000000000000000000000001000000000000000000000000000001000000000000000000000000000000010001000000000101
0000000000000100000105010000000000000000000001000001000100000007000000000000000000000000000000000000000000000100000000000000010101010101010001000000000000000000000000000000010001000000000001
0000000000000100000100010000000000000000000000000001000100000007000000000000000000000000000100000000010000010000000000000000000000000007010001000000000000000000000000000001000001000000000001
0000000000000104040100010404040404040404040404040401100100000007000000000000000000000000000100000000010001000000000000000000000000000007010001000000000000000001000100000001000001010101010101
0000000000000101010100010101010101010101010101010101010101010101011001000000000000010100000101000101010100000000000000000000010101010101010401010101010110010101000101010100000000000000000000
</map>
<tip>
tonto el que lo lea
</tip>