<map>
00000000000000000000000000000000000000000000000000000000000000000000000000000000090800000000000001000000010000000000000000000000000000000000000000000001010000000000000000000000000000000000000000000000000000000000000000
00000000000000000000000000000000000000000000000000000000000000000000000000000000090800000000000001000000010000000000000000000000000000000000000000000001010000000000000000000006000000000000000006010000000000000000000000
00000000000000000000000000000000000000000000000000000000000000000000000000000000090800000000000001000000010000000000000000000000010101010100000000000001010000000000000000000001000000000000000000000000000000000001000000
00000000000000000000000000000000151515151515000202020202020000000000000000000000090800000000000001000000010000000000000000000000060601080101000000000001010000000000000000000000000001060000000000000000000000000000000000
00000000000000000000000000000000000000000000000000000000000000000000000000000000090800000000000001000000010000000000000000000000000000010101010000000001010000000000000000000000000000000000000000000000000000000000000000
00000000000000000000000000000000000000000000000000000000000000000000000000000000090800000000000001000000010000000000000000000000040401010101010100000001010000000000000100000000000000000000000700000000010000000000000000
00000000000000000000000000000000000000000000000000000000000001010101000000000000090803000000000000000000000000000000000000000000010101010101010100000001010000000000000000000000000000000000000000000000000000000000000000
01010101010101010101010101010101010101010101010101010101010100000000010000000101010101010000000000000000000000000000000000000000000000000101010100000001010000000000000000000000000000000006000000000000000000000000000001
01000000000000000000000000000000000000000000000000000000000000000000000000000000090800000000000000000000000000000000000000000000000000000001010100000012130000000000000000000000060000000001000000000000000000110000000000
00000000000000000000000000000000000000000000000000000000000000000000000000000000090800000000010000000100000001010101010101010101010000000008030800000000000000000000000000000000000000000000000000000000000000110000000000
00000000000000000000000000000000000000000000000000000000000000000000000000000000090800000000010000000100000001000000000000000000010000000101010100010110100101100100000000000000000000000000000000000000000011110000000000
00000000000000000000000000000000000000000000000000000000000000000000000000000000090800000000010000000100000001000000000000000000010000010101010100010000000100000000000000000000000000000000000000000000000000000000000000
00000000000000000000000000000000000000000000000000000000000000000000000000000000090800000000010000000100000001000000000000000000010000010101010000010000000100000000000000061111111111111111111111061111000000000000000000
00000000000000000000000000000000000000000000000000000000000000000000000000000000090800000000010000000100000001000000000000000000010000010101000000010000000100000000000000010000000000070700000000000000000000000001000000
</map>
<tip>
que no
</tip>
