<map>
00000000000000000000000000000000000000000000000000000000000000000000000000000000000000000000000000000000000000000000000000000000000000000000000000000000000000000000000000000000000000000000000000000000000000000000000000000000000000000101010000000000000000000000000000000000000000000000000000000000000000000000000000060606060606000000000000000000000000000000000000000000000000000000000000000000000000
00000000000000000000000000000000000000000000000000000000000000000000000000000000000000000000000000000000000000000000000000000000000000000000000000000000000000000000000000000000000000000000000000000000000000000000000000000000000000000007010000000000000000000000000000000000000000000000000000000000000000000000000000000000000000000000000000000000000000000000000000000000000000000000000000000000000000
00000000000000000000000000000000000000000000000000000000000000000000000000000000000000000000000000000000000000000000000000000000000000000000000000000000000000000000000000000000000000000000000000000000000000000000000000000000000000000007010000000000000000000000000000000000000000000000000000000000000000000000000000000000000000000000000000000000000000000000000000000000000000000000000000000000000000
00000000000000000000000000000000000000000000000000000000000000000000000000000000000000000000000000000000000000000000000000000000000000000000000000000000000000000000020000000000000000000000000000000000000000000000000000000000000000000007010000000000000000000000000000000000000000000000000000000000000000000000000000000000000000000000000701000000000101010101010101010000000000000000000000000000000000
00000000000000000000000000000000000000000000000000000000000000000000000000000000000000000000000000000000000000000000000000000000000000000000000000000000000000000000000000000101010101010101010000000000000000000000000000000001010101010101010000000000000000000000000000000000000000000000000000000000000000000000000000000000000000000000000701000000010100000000000000000000000000000000000000000000000000
00000000000000000000000000000000000000000000000000000000000000000000000000000000000000010101000000000000000000000000000000000000000000000000000000000000000000000000000000000909090909090907010000000000000000000000000000000001060606060606000000000000000000000000000000000000000000000000000000000000000000000000000000000000000000000000000001010001010000000001010101010000000000000000000001010101010100
00000000000000000000000000000000000000000000000000000000000000000000000000000000000000010001000000000000000000000000000000000000000000000000000000000000000000010101010101120101010101090909010101010404040101010101010101010101090909000000000000000000000000000000000000000000000000000000000000000000000000000101010101010110100101010101010000010101000000000101000000010000000000000000000000000000000101
00000000000000000000000000000000000000000000000000000000000000000000000000000000000000010001000000000000000000000000000000000000000000000000000000000000000001010000000000000000000001090909060606010101010106060606060606060606090909000000000000000000000000000000000000000000000000000000000000000000100000000000000000000000000000000000010100000000000000010100000000010000000000000000000000000000000001
00000000000000000000000000010100000000000000000000000000000000000000000000000000000000010001000009000000000000000000000001010100000000000000000000000800000001000000000000000000000001090909090909060606060609090909090909090909090909000000000000000000000000000000000000000000000000000000000000000000000000000000000000000000000000000000000100000000000001010000000000010000000000000000000000000000000001
00000000000000000000000000000000000000000001010100000000010101000000000101010110040404010001010101010101010000000000000000000000000000000000000001010101010101000000000000000000000001090909090909090909090909090909090909090909090909000008000000000000000004040000000000000000000000000000000000000000000000000000000000000000000000000000000101010101010101000000000000010000000000010101010000000000000001
01010101010101010101011200000000000000000000000000000000000000000000000000000000000000000000000000000000000000000000000000000000000000000000000000000000000000000000000000000000000001090909090909090909090909090909090909090909090909010101010101010101010101010101010112000000000101010100000000000000000000000000000000000000000000000000000000000000000000000000000000010000000000010000011111111111111101
00000000000000000000000000000000000101010000000000000000000000000000000000000000000000000000000000000000000000010000000000000000000101010000000000000000000000000000000000000000000001090909090909090909090909090909090909090909090909010000000000000000000000000000000000000000000000000000001000000000000000000000000000000000000000000000000000000000000000000000000000000000000000000000000000000000000000
00000000000000000000000000000000000000000000000000000000000000000000000000000000000000000000000000000000000000000000000000000000000000000000000000000000000000000000000000000000000001010101010101090909090909090909090909090909090909010000000000000000000000000000000000000000000000000000000000000000000000000000000000000000000000000000000000000000000000000000000000000000000000000000000000000000000000
00000000000000000000000000000000000000000000000000000000000000000000000000000000000000000000000000000000000000000000000000000000000000000000000000000000000000000000000000000000000000000000000001010101120909090912010101010101010101010000000000000000000000000000000000000000000000000000000000000000000000000000000000000000000000000000000000000000000000000000000000000000000000000000000000000000000000
</map>
<tip>
No vivas de que hacer vive de "callate alv"
</tip>
