<map>
00000000000000000000000000000000000000000000000000000000000900000000000000000000000000000000000000000000000000000000000000000000000000000000000000000000000000000000000000000000000000000000
00000000000000000000000000000000000000000000000000000000000000000000000000000000000000000000000000000000000000000000000000000000000000000000000000000000000000000000000000000000000000000000
00000000000000000000000000000000000000000000000000000000000000000000000000000000000000000000000000000000000000000000000000000000000000000000000000000000000000000000000000000000000000000000
00000000000000000000000000000000000000000000000000000000000000000000000000000000000000000000000000000000000000000000000000000000000000000000000000000000000000000000000000000000000000000000
00000000000000000000000000000000000000000000000000000000000000000000000000000000000000000000000000000000000000000000000000000000000000000000000000000000000000000000000000000000000000000000
00000000000000000000000000000000000000000000000000000000000000000000000000000000000000000000000000000000000000000000000000000000000000000000000000000000000000000000000000000000000000000000
00000000000000000000000000000000000000000000000000000000000000000000000000000000000000000000000000000000000000000000000000000000000000000000000000000000000000000000000000000000000000000000
00000000000000000000000000000000000000000000000000000000000000000000000000000000000000000000000000000000000000000000000000000000000000000000000000000000000000000000000000000000000000000000
00000000000000000000000000000000000000000000000000000000000000010000000000000000000000000000000000000000000000000000000000000000000000000000000000000000010101010101010100000000000000000000
00000000000000000000000000000000000000000000000000000000000001050000000000000000000000000000000000000000000000000000000000000000000000000000000000000000070101010105000000000000000000000000
00000000000000000000000000000000000000000000000000000000000001050000000000000000000000000000000000000802000000000000000000000000000000030000000000000000070101010105000000000000000000000000
00000000000000000000000000000000000000000000000000000000000001050000130000000000000000000000000000000000000001010101010101011006040507010101010100000000070101010105000000000000000000000000
00000000000000000000001010100000001010100010101000010101011001050000000000000000001010100014000000000101010000000000000000000000050507070000000000001000070101010105000000000000000000000000
01010101010101100404040404100404040404100404040401010901010101050000000000001004040404040401010101010100010101010101010101010101050507070000000101010101010101010101111100111111111111110404
</map>
<tip>
elige
</tip>
