<map>
00000000000000000000000000000000000000000000000000000000000000000000000000000000000000000000000000000000000000000000000000000000000000000000000000000000000000000000000000000000000000000000000000000000000000000000000000000000000000000000000000000000000000000000000000000000000000000000000000000000000000000000000000
00000000000000000000000000000000000000000000000000000000000000000000000000000000000000000000000000000000000000000000000000000000000000000000000000000000000000000000000000000000000000000000000000000000000000000000000000000000000000000000000000000000000000000000000000000000000000000000000000000000000000000000000000
00000000000000000000000000000000000000000000000000000000000000000000000000000000000000000000000000000000000000000000000000000000000000010101000000000000000000000000000000000000000000000000000000000000000000000000000000000000000000000000000000000000000000000000000000000000000000000000000000000000000000000000111111
00000000000000000000000000000000000000000000000000000000000000000000000000000000000000000000000000000000000000000000000000000000000001010001000000000000000000000000000000000000000000010000000000000000000000000000000000000000000000010100000000000000000000000000000000000000000000000000000000000000000100000000000011
00000000000000000000000000000000000000000000000001010101010606060606060606060606060606000000000000000000000000000000000000010101000701010000000000000000000000000000000000000000000000010000000000000000000000000000000000000000000001000001000000000000000000000100000000000000000000000000000000000000000111000000000011
00000000000000000000000000000000000000000000000001010101010000000000000000000000000000000000000000000000000000000000000001010001040007010100000000000000000000000000000000000000000101010000000000000000000000000000000000000000000100000001000000000000000000000100000000000000000000000000000000000000010111000000000011
00000000000000000000000000000000000000000000000001010101010000000000000000000000000000000000000000000000000000000000000101000001010400040100000000000000000000000000000000000000000100000000000000000000000000000000000000000000000100000001000000000000000000000100000000000000000000000000000000000000010111000000000011
00000000000000000000000000000000000000000000000001010101010000000000000000000000000000000000000000000000000000000000010100000000010104010100000000010101000404000000000000000000010000000000000000000000060606060606060600000000010000000001000000000000000000010100000000000000000000000000000000000000010111111111111111
00000000000000000000000000000000000000000000000001010101010000000000000000000000000000000000000000000000000000000001010000000000000101010000000000000001010101000000000000000001010000000000000000000000000000000000000000000001000000000001000000000000000000010100000000000000000000000000000000000001010100000000000000
00000000000000000000000000000000000000000000000001010101010000000000000000000000000000000000000000000101010101010101000000000000000000000000000000000000000001010101000000010100000000000000000000000000000000000000000000000100000000000001000000000000000000010000000000000000000000000000000000000001010000000000000000
00000000000000000000000000000000000000000000000001010101010000000000000000000000000000000000000000000000000000000000000000000000000000000000000000000000000000000001000101010000000000000000000000000000000000000000000000010100000000000001000000000000000001010000000000000000000001000001010101010001000000000000000000
00000000000000000000000000000000000000000000000013131313130000000000000000000000000000000000000000000000000000000000000000000000000000000000000000000000000000000000000000000000000000000000000000000000000000000000000000010100000000000001000000000000000001000000000000000000000001000000000000000000000000000000000000
00000000000000000000000000000000000000000000000000000000000000000000000000000000000000000000000000000000000000000000000000000000000000000000000000000000000000000000000000000000000000000000000000000000000000000000000000010100000000000001000000000000000001000000000000000000000001000000000000000000000000000000000000
01010101010101010101010101010101010101010101010110101010101010101010101010101010101010101010101000000000000000000000000000000000000000000000000000000000000000000000000000000000000000000001010101010101010101010101010101010100000000000001010101010101010101000000000101010101010101040404040404040400000000000000000000
</map>
<tip>

</tip>