<map>
000000000000000000000000000000000000000000000000000000000000000000000000000000000000000000000000000000000000000000000000000000000000000000000000000000000000000000000000000000000000010101010101010104000000000000000000000000011101011101000000000000000001090100000000000100000001000000000000000000000000
000000000000000000000001010101010101010101000000000000000000000000000000000000000000000000000000000000000000000000000000000000000000000000000000000000000000000000000000000000040404010000000010000101000000000000000000000000011101011101000000000000000001090100000000000100000401000000000000000001010101
000000000000000000000001111111111111111101000000000000000000000000000000000000000000000000000000040400000000000000000000000000000000000000000000000000000000000000000000000000010101010000000010000001040000000000000000000000011111111101000000000000000001090100000000000100000101000000000000000001000000
000000000000000000000001010101111111111101000000000000000000000000000000000000000000000000010101010101000000000000000000000000000000000000000000000000000000000000000000000000010000100000000010000001010101010105000000000000010101111101000000000000000001090100000000000104040100000000000000000001000101
000000000000000000000000000001010101010101000000000000000000000000000000000000000000000101011111111101000000000000000000000000000000000000000000000000000000000000000000000001010000100000000010000000000010000101010105000000000001010101000000000000000001010100000000000101010100000000000000000001000001
000000000000000000000000000000000000000006000000000000000000000000000004010101010000000111111111111101000000000000000000000000001010100000000000000004040101010100000000000001000000000000000010000000000010000000000105000000000000000000000000000000000006060600000000000000000000000000000000000001010101
000000000000000000000000000000000000000000000000000000000000000000000001011111010000000101011111111101000000000000000000000001010111010000000000010101010111110100000000000000000000000000000006000000000010000000000101000000000000000000000000000000000000000000000002000000000000000000000004000000000000
000001010101010100000000000000000000000000000000000000000400000000000001111111010000000000011111111101010101010101010400000101111111010000000000011111111111110100000000000000000000000000000000000000000010000000000000000000000000000000000000000000000000000000000000000000000000000111111101000000000000
000001111111110100000001010101010404000000000001010101010101010000000001111111010000000000011111111111111111111111010100000111111111010000000000010101010101010100000000000000000000000000000000000000000000000000000000000000000000000000000000000101010100000000000000000000000000100109090901000001010101
000001111111110101010101111111010101010101000001111111111111011010000001111111010400000000011111111111111111111111110100000111111111010000000000011111111111110100000000000000000000000400000000000000000000000000000000000000000000000000000000010108080100000000000101010100000001010109090901000001000000
000001111111111111111111111111111111111101000001111111111111010101000001111111010100000000010111110101011111010101110100000111111111010000000000010101010101010100000001010000000101010100000000000000000000000000000000000000000000000101010000010809080100000001010111110100000001090909090901000001000101
000001110101011101010111010101110101011101000001111111111111111101000001111111110100000000000111110108011111010801110100000111111111010000000000011111111111110100000001000000000108080100000000000000000001010101010100000000010101010108010000010809080100000001111103110100000001090909090901000001000001
000001110108011101080111010801110108011101000001111111111111111101000001111111110100000000000111110108011111010801110100000111111111010000000000010101010101010100000001000000000108080100000101010100000001030303030101010101010808080808010000010809080100000001110303110100000001090909090901000001010101
000001110108011101080111010801110108011101000001111111111111111101000001111111110100000000000111110108011111010801110100000111111111010000000000011111111111110100000001000000000108080100000109090100000001030303030303060606010808080808010000010809080100000001110303110100000001090909090901000000000000
</map>
<tip>
GG
</tip>