<map>
00000000000000000000000000000000000000000000000000000101010100000000000000000000000000000000010101010101010101000400000000040000040004000000000400000400040000040004000000000400000400000000
00000000000000000000000002000000000000000000000000000109090100000000000000000000000000000000010909090909090901000600000000060000010006000000000600000100060000010006000000000600000100000000
00000000000000000000000000000000000000000000000000000109090100000000000001010101000000000000010909090909090901000000140000000000010000001400000000000100000000010000001400000000000100000011
00000000000000000000000000000000000000000000000000000109090100000000000001090901000000000000010909090909090901000000010000000000010000000100000000000100000000010000000100000000000100000001
00000000000000000000000000000000090000000000000000000109090100000000000001090901000000000000010909090909090901000000010000000000060000000100000000000600000000060000000100000000000100000001
00000001010101010101010101010101010101000000000000000101010100000000000001010101000000000000010101010101010101000000010000000000000000000100000000000000000000000000000100000000000600000001
00000001090901090901090901090901090901000000000000000000000000000000000000000000000000000000000000000000000006001300000000140000000013000000001400000000140000000013000000001400000000130000
00000001090901090901090901090901090901000000000000000000000000000000000000000000000000000000000000000000000000000100000000010000000001000000000100000000010000000001000000000100000000010000
00000001010101010101010101010101010101000000000000000101010100000000000001010101000000000000000000000000000000000100000000010000000001000000000100000000010000000001000000000100000000010000
00000000000000000000000000000000000000000000000000000109090100000000000001090901000000000000000000000300000000000100000000010000000001000000000100000000010000000001000000000100000000010000
00000000000000000000000000000000000000000000000000000109090100000000000001090901000000000000010101010101010101000000000000000000130000000000000000001300000000130000000000000000001300000000
00000000000000000000000000000000000000000000000000000109090100000000000001010101000000000000010909090909090901000000000000000000010000000000000000000100000000010000000000000000000100000000
00000000000000000000000000000000000000000000000000000109090100000000000000000000000000000000010909090909090901000000000000000000010000000000000000000100000000010000000000000000000100000000
00000000000000000000000000000000000000000000000000000101010100000000000000000000000000000000010101010101010101000000000000000000010000000000000000000100000000010000000000000000000100000000
</map>
<tip>
Este nivel SI es posible.
</tip>
