<map>
000000000000000000000000000000000000000000000000000000000000000000000000000000000000010101010101
000000000000000000000000000000000000000000000000000000000000000000000000000000000000000000000001
000000000000000000000000000000000000000000000000000000000000000000000000000000000000000000000001
000000000000000000000000000000000000000000000000000000000000000000000000000000000000000000000001
000000000000000000000000000000010000010000010000010000010000010000010000010000010000121111111101
000000000000000000000000000000000000000000000000000000000000000000000000000000000000010000000000
000000000000000000000000000000000000000000000000000000000000000000000000000000000000010000000000
000000000000000000000000000000010000010000010000010000010000010000010000010000010000010000000000
000000000000000000000000000000000000000000000000000000000000000000000000000000000000010000000000
000000000000000000000000000000000000000000000000000000000000000000000000000000000000010000000000
000000000000000000000000000000020000010000010000010000010000010000010000010000010000010000000000
000000000000000000000000000000000000000000000000000000000000000000000000000000000000010000000000
000000000000000000000000000000000000000000000000000000000000000000000000000000000000010000000000
010101010101010101010101010101010101010101010101010101010101010101010101010101010101010000000000
</map>
<tip>
Tu puedes!
</tip>
