<map>
000000000000000000000000000000000000000000000000000000000000000000000000000000000000000000000000000000000000000000000000000000000000000000000000000000000000000000000000000000000000000000000000000000000000000000
000000000000000000000000000000000000000000000000000000000000000000000000000000000000000000000000000000000000000000000000000000000000000000000000000000000000000000000000000000000000000000000000000000000000000000
000000000000000000000000000000000000000000000000000000000000000000000000000000000000000000000000000000000000000000000000000000000000000000000000000000000000000000000000000000000000000000000000000000000000000000
000000000000000000000000000000000000000000000000000000000000000000000000000000000000000000000000000000000000000000000000000000000000000000000000000000000000000000000000010000000000000000000000000000000000000000
000000000000000000000000000000000000000000000000000000000000000000000000000000000000000000000000000000000000000000000000000000000000000000000000000000000000000000000001000001100000000000000000000000000000000000
000000000000000000000000000000000000000000000000000000000000000000000000000000000000000000000000000000000000000000000000000000000000000000000000000000000000000000000100000101000000000000000000000000000000000000
000000000000000100000000000000000000000701000000000000000000000000000000000000000000000000000000000000000000000000000000000000000000000004000004040400000000000000010000010100000000000000000000000000000000000000
000000000000000000000000000000000000000701000000000000000000000000000000000000000000000000000000000000000000000101010101010000000000000000000000000000000000000001000001010000000000000000000000000000000000000000
000000000000000000000000000001000000000701000000000000000000000000000000000000000000000000010000000004000000000100000000010000100000100000000000000000000000000100000101000000000000000000010105000000000000000002
000000000000000000000010000000000004040401000000000000000000000000000000000000000000000401000001010101010000000111111111010000010000010000000000000200000000010000010100000000000000000000000105000000000000000000
000000000000000000000000000000000001010101000000000000000000000000000000000000000012000100000100000000010001000100000000010000010000010000000000000000000001000001010000000000000000000000000101050400000000000000
000000000000000000000000000000000000000000000000100000000000000001100000000000010101010000010011111111010101010100000000010101010101010101000000000000000000000101000000000000000000000000000001010101010111111111
000000000000000000000000000000000000000000000000000000000000000000000000000000000000000001000000000000000000000000000000000000000000000000010011111101010101010100000000000000000000000000000000000000000000000000
000000000000000000000000000000000000000000000000000000000000000000000000000101010101010100000000000000000000000000000000000000000000000000000100000000000000000000000000000000000000000000000000000000000000000000
</map>
<tip>
Diviertete
</tip>
