<map>
000000000000000000000000000000000000000000000000000000000000000000000000000000000705000000000000000000000000
000000000000000000000000000000000000000000000000000000000000000000000000000000000705000000000000000000000000
000000000000000000000000000000000000000000000000000000000000000000000000000000000705000000000000000000000000
000000000000000000000000000000000000000000000000000000000000000000000000000000000705000000000000000000000000
000000000000000000000000000000000000000000000000000000000000000000000000000000000705000000000000000000000000
000000000000000000000000000000000000000000000000000000000202020200000000000000000705000000000000000000000000
000000000000000000000000000000000000000000000000000000000000000000000000000000000705000000000000000000000000
000000000000000000000000000000000000000000000000000000000000000000000000000000000705000000000000000000000000
010101010101010101010110100000001010101010040404040404010101010101000000070500000705000000000000000000000000
010000000000000000000000010000000101010101010101010101010000000001010111111111111111111111111111111111111111
010000000000000000000000010000000100000000000000000000000000000000000000000000000000000000000000000000000000
010000000000000000000000010404040100000000000000000000000000000000000000000000000000000000000000000000000000
010000000000000000000000000000000000000000000000000000000000000000000000000000000000000000000000000000000000
010000000000000000000000000000000000000000000000000000000000000000000000000000000000000000000000000000000000
</map>
<tip>
no
</tip>
