<map>
00000000000000000000000000000000000000000000000000000000000000000000000000000000000000000000000000000000000000000000000000000000000100000000070105000701050000000000000000000000000000000000000000000000000000000000000000000000000000000000000000000000000000000000000000000000000000000000000000000000111111
00000000000000000000000000010000000000000001000000000001000000000001000000000000000000000000000000000000000000000000000000000000000100000000000100000001000101010000000000000000000000000000000000000000000000000000000000000000000000000000000000000000000000000000000000000000000000000000000000000000000011
00000000000000000000000000010000000000000001000000000001000000000001000000000000000000000000000000010101010100000000000000000000000100000000000100000001000000010000000000000000000000000000000000000000000000000000000000000000000000000000000000000000000000000000000000000000000000000000000000000000000011
00000000000000000002000000010004040404040001000404040001000404040001000101010000000000000000000000010000000100000000000000000000000100000013000000130000001300010000000000000000000000000000000000000000000000000000000000000000000000000000000000000000000000000000000000000000000000000000000000000000000011
00000000000000000000000000060001010101010006000101010006000101010006000000000000000000010000000000010000000100000309000000000000000100000001000000010000000100010000000000000000000000000000000000000000000000000000000000000000000000000000000000000000000001010101010101010100000000000000000000000000000011
00000000000000000000000000000000000000000000000000000000000000000000000000000000000000010001010100010000000100010101000101010101010100000001000000010000000100000000000000000000000000000000000000000000000000000000000000000000000000000000000000000000000001000000000000000000000000010000000000111111111111
00000000010101010101010000000000010101000000000001000000000001000000000001000000000000010000000100010000000100010000000000000000000000000001000000010000000103000000000000000000000000000000000000000000000000000400000000000400000000000401010101010101010101000000000000000000000000010000000000000000000000
00000000000000000000000000000000000000000000000000000000000000000000000000000100000000010000000100010000000100010000001300000013000000130000001300000013000000010101010101010101010101010101010101010101000000000100000000000100000000000100000000040000000000000000000000000000000012121201000000000000000000
00000000000000000000000000000000000000000000000000000000000000000000000000000000010000010000000100010101010100010000000100000001000000010000000100000001000000000000000000000000000000000000000000000000000000000100000000000100000000000100010101010000000000000000000000000000000000000001000000000000000000
00000000000000000000000000000000000000000000000000000000000000000000000000000000000010010000000100000000000000010000000100000001000000010000000100000001000000010101010000010000010000010000010000010000010101010101010101010101010101010100000000000000000000000000000000000000000000010001000000000000000000
00000000000000000000000000000000000000000000000000000000000000000000000000000000000000000000000101010101010101010000000100000001000000010000000100000001000000010000000000000000000000000000000000000000000000000000000000000000000000000000000000000000000000000000000000000000000000010001000000000000000000
00000000000000000000000000000000000000000000000000000000000000000000000000000000000000000000000000000000000000000000000000000000000000000000000000000000000000010000000000000000000000000000000000000000000000000000000000000000000000000000000000000000000000000000000000000000000000010001000000000000000000
00000000000000000000000000000000000000000000000000000000000000000000000000000000000000000000000000000000000000000000000000000000000000000000000000000000000000010000000000000000000000000000000000000000000000000000000000000000000000000000000000000000000000000000000000000000000000010001000000000000000000
00000000000000000000000000000000000000000000000000000000000000000000000000000000000000000000000000000000000000000000000000000000000000000000000000000000000000010000000000000000000000000000000000000000000000000000000000000000000000000000000000000000000000000000000000000000000000010001000000000000000000
</map>
<tip>
dificil?
</tip>
