<map>
000000000000000000000000000000000000000000000000000000000000070000030000000000000000000000000000000000070000010000010101010101000000000000000000000000070000000000000003000000000000000000000000000000000000000000000007010104040404040404010101010101010101010101010101010101010101010101010101010101010101010100000000000000000000000000000000000000000000000000000000000000000000000000000000000000000000000000000000000000000000000000000000000000000000000000000000000000000000000000000000000000000000
000000000000000000000000000000000000000000000000000000000000070000030000000000000000000000000101040404040000000000010003000004040404040404000000000000070000000000000003000000000000010100000101000000010101000000000007000000000000000000000000000000000000000000000000000000000000000000000000000000000000000100000000000000000000000000000000040000000000000000000000000000000000000000000000000000000000000000000000000000000000000000000000000000000000000000000000000000000000000000000000001111111111
000000000000000000000000000000000000000000000000000400000000070000030000000000000000010404040100000000000000010000010003010001000000000000000000000000000000000000000003000000000000010100000606000000010101010104040401000000000000000100010101000000010000000100000001010000000001000000000100000001000000000100000101010101010101000007040404040404040400000000000000000000000000000000000000000000000000000000000000000000000000000000000000000000000000000000000000000000000000000000000000000000000011
000000000000000000000000000000000000000000000000000101010101010000030000000000000101000000000100000000000000010000010003010001000001010101010101100101010100000000000003000001010000060600000000000000010100000000000001000000000101010100010101000000000000000000000000000000000000000000000000000000010100010101010000000001000001000007000000010000000100000000000000000000000000000000000000000000000000000000000000000000000000000000000000000000000000000000000000000000000000000000000001000000000011
000000000000000000000000000000000000000000000000000000000700000000030000000000000100000000000100000000010000000000000003010000000000000000000000000000000100000000000003000001010000000000000000000000010100000000000003000000000000000000000000000000000000000000000000000000000000000000000000000000000101010000010000000001000001000007000000010000000100000000000001010101000000000001000000000001000000000100000001000000000001000001000001000000000001000000000000000000000000000000000000000000000011
000000000000000000040001000000000000000000000000000000000700000000030000000001010000000101000000000404010000040000010101010101000000000000000000000000000100000000000003000006060000000000000000000000010100000000000003000010100000000004040404040400000000000000000000000000000000000000000000000000000000010000010000000001000001000001000000010000000100000000000001000000000000000001000000000001000000000100000001000000000001000000000001000000000001000000000000000000000000000300000000000000000011
000000000000000000010101000000000000000101010101000000000700000000030000000000000000000101000001010000010000010001010101010000000001010101010101010101010101000000000001000000000000000000000606000000000000000000000101010110000000000000000000000000000000000000000000000000000000000000000000000000000000010000010000000000000001000001000000000000000100000000000001000000000000000001000000000001000000000100000001000000000001000000000001000000000001040404040404040000000000000300000000001111111111
000000000000000101010000000000000000000000000000000000000700000004010101010100000001010100000100000000010000010001000000000000000003000001000000010001000001000001010101000000000000000000000000000000000000000000000000070000000000000000000000000000000000000000000000000000000000000000000000000000000000010000000000000001000001000000000000010000000300000000000000000000010000000000000000000000000000000004040400000000000000000000000000000000000000000000000000000000000000010100000000000000000000
000000000001010100000000000000000004000000000000000000000700000000000000000000000000000000000100000000010000010000000001010000000001000001000000010001000001000001000000000006060000000606000000000000000000000100000000070000000000000000000000000000000000000000000000000000000000000000000000000000000000010000010000000001000000000001000000010000000101011010000000000000010000000000000000000000000000000000000700000000000000000000000000000000000000000000000000000000000000010100000000000000000000
000000000100000000000000010101010101000000000000000000000700000000000000000000000000000000000100000000000000010000010101010000000003000001000000000001000001000101000000000000000000000000000000010101000000000000000000070000000000000000000000000000000000000000000000000000000000000000000000000000000003030000010000000001000001000001000000010000000100000000000000000001000000000000000000000000000000000000000700000000000000000000000000000000000000000000000000000000000001010100000000000000000000
000000010100000000000000000000000000000000000000000000000000100000000000000000010101010100000000000000010000000001010001010000000001000000000000010000000000000100000000101010101010101010101001010101010101010401010101010000000000000000000000000000000000000000000000000000000000000000000001010100000003030000010000000001000001000001000000010000000100000000000000000001000000000000000000000000000000000000000700000000000000000000000000000000000000000000000000000000000001010000000000000000000000
000000000000000000000000000000000000000000000000000000000000010000000000000000000000000100000100000000010000010001000001010101010101000001000000010001000001010100000000000000000000000000000000000000000000000000000000000000000000000000000000000000000000000000000004040404040404040401010101000101010100010000010404040401040404040404040404010404040100000000000000000001000000000000000000000000000000000000000700000000000000000000000000000000000000000000000000000001010101000000000000000000000000
000000000000000000000000000000000000000000000000000101010101010000000000000000000000000100000100010100010000010001000001010000000001000001000000010001000001000000000000000000000000000000000000000000000000000000000000000000000000000000000000000004040404040404040400000000000000000000000000000000000000010000010000000000000000000000000000000000000100000000000000000001010101010101010100000000000101010101010700000000000000000000000000000000000000000000000000000001000000000000000000000000000000
000000000000000000000000000000000000000000000000000000000000000000000000000000000000000000000100000000010404040404040404000000000000000001000000010001000001000000000000000000000000000000000000000000000000000000000000000000000000000000000000000000000000000000000000000000000000000000000000000000000000010000000000000000000000000000000000000000000000000000000000000000000000000000000101010101010000000000000000000000000000000000000000010101010101010101010101010101000000000000000000000000000000
</map>
<tip>

</tip>