<map>
000000000000000000000000000000000000000000000000000101010101000000000000000000000000000000000000000000
000000000000000000000000000000000000000000000000000101010101000000000000000000000000000000000000000000
000000000000000000000000000000000000000000000000000101010101000000000000000000000000000000000000000000
000000000000000000000000000000000000000000000000001401010101000000000000000000000000000000000101010101
000000000000000000000000000000000000000000000000000001010101000000000000000000000000000000000100000001
000000000000000000000000000000000000000000000000000001010101000000000000000101140000000000000000001101
000000000000000000000000000000000000000000000000000001010101000000001313130100010000000012000001010001
000000000000000000000000000000000000000000000100000001010101000000120101010000000000001201000100000001
000000000000000000000000000000000000000000010100000000000000000000010000000000000000121201000100000001
010000000000000000000000000000000000000901010100000003000000001300000000000000001412010101000100000001
010100000000000000000101010401010101010101010100000003010101000100000000000000000101010000000101010101
010000000000000000010000000000000001000000000000000001010101000000000000000000000000000000000000000101
010101010101010101010000000000000000000000000000000001010101000000000000000000000000000000000000000001
000000000000000000000000000000000000000000000000000001010101000000000000000000000000000000000000000000
</map>
<tip>

</tip>
