<map>
010000000000000000000000000000000000000000000404040401010000000000000000000000000000000000000000000000000000000000000000000000000000000000000000000000000000000000000000000000000000000000000000000000000000000000000000000000000000000000000000000000000000000000000000000000000000000000000000000000000000000000000000000000000000000000000000000000000000000700000000000000000000000000000000000000000000000000000000000001010101010101010101000001010100000001010101010101010101010101010101010101010101010101010101000000000000000000000000000000000000000000000000000000000000000000000000000000000000000000000000000000000000
010000000000000000000000000000000000000000000100000000010000000000000000000000000000000000000000000000000000000000000000000000000000000000000000000000000000000000000000000000000000000000000000000000000000000000000000000000000000000000000000000000000000000000000000000000000000000000000000000000000000000000000000000000000000000000000000000000000000000700000000000000000000000000000000000000000000000000000000000101010101010101010101010101010101010101010101010101010101010101010101010101010101010101010101000000000000000000000000000000000000000000000000000000000000000000000000000000000000000000000000000000000000
010000000000000000000000000000000000000100000100000007010000000000000000000000000000000000000000000000000000000000000000000003000000000000000000000000000000000000000000000000000000000000000000000000000000000000000000000000000000000000000000000000000000000000000000000000000000000000000000000000000000000000000000000000000000000000000000000000000000000100000000000000000000000000000000000000000000000000000000000101010101010101010101010101010101010101010101010101010101010101010101010101010101010101010101000000000000000000000000000000000000000000000000000000000000000000000000000000000000000000000000000000000000
010000000000000000000000000000000000000100000000000000010000000000000000000000000000000000000000000000000000000000000000000101010100000000000000000000000000000000000000000000000000000000000000000000000000000000000000000000000000000000000000000000000000000000000000000000000000000000000000000000000000000000000000000000000000010100000101010707070707070101010101010101010101010101010101010101010101010101010101010101010101010101010101010101010606060606060601010101010101010101010101000000000001010101000000000000000000000000000000000000000000000000000000000000000000000000000000000000000000000000000000000000000000
010000000000000000000000000000000000010100000000010000010000000000000000000000000001010100000000000000000000000000000000000100000101000000000000000000000000000000000000000000000000000000000000000000000000000000000000000000000000000000000000000000000000000000000000000000000000000000000000000000000000000000000000000000000000010100000000000000000000000000000000000000000000000000000000000000000000000000000000000000000000000000000000000000000000000000000006010101010101010101000000000000000000000101000000000000000000000000000000000000000000000000000000000000000000000000000000000000000000000000000000000000000000
010000000000000000000000000000000000010004000101010000010000000000000000000000010101000000000000000000000000000000000000010100000001010000000000000000000000000000000400000000000000000000000000000000000000000000000000000000000000000000000000010101000000000000000000000000000000000000000000000000000000000000000000000000000000010100000000000000000000000000000000000000000000000000000000000000000001000001000000000000000000000000000000000000000000000000000000060601010101010100000000000000000000000001000000000000000000000000000000000000000000000000000000000000000000010101010101000000000000000000000000000000000000
010000000000000000000000000000000001010000000000010000010000000000000000000101010001000100000000000000000000000000000000010100000000010000000000000000000000000000000100000000000000000004000000000004000000000000000000000000000000000000000001010101000000000000000000000000000000000000000000000000000000000000000000000000000001010100000101010101010101010100000001010101010101010100000000000101010101010101000000001213000000000000000000000000040404000000000000000606010101010000000000000000000000000000000000040404040000000000000000000000000000000000000000000000000000000000000000010000000000000000000000000000000000
010100000000000000000000000000000001000000000000010000010101010101010101010100010000000100000000000000000000000000000001010100000000010100000000000000000000000000000100000000000000000001000000000001000000000000040000000000000008030000000001010101000000000000000000000000000000000000000000000000000000000000000000000000000001000100000000000000000000000100000000000000000000000100000000000000000000000001000000001213000000000000000000040404010101040400000000000000000000000000000000000000000400000000000000010101010400000000000000000000000000000000000000000000000000000000000000010000000000000000000000000000000000
000101000000000000000000000000000101000000000000010000010100000000000001000100000001000100000000000000000000000000000001010100000000000100000000000000000000000000000100000000000000000001000000000001000000000000010000000004040101010100000000000000000000000000000000000000000000000000000000000000000000000000000000000000000001000100000000000000000000000100000000000000000000000100000000000000000000000001010000030000000000000000000004010101010101010104040000000000000000000000000000000004040101010101000000010101010104040400000000000000000000000000000000001414141414141414000000010000000000000000000000000000000000
000001010101010101000000000000000100000000000000010000010000000000000001000000010001010110101010101010000000000000000101010100000000000101010000010101010101010101010101010101010101010101010101010101010101010101010101010101010101010100000000000000000000000000000000000000000000000000000000000000000000000000000000000000000101000101010101010101010101010101010101010101010101010100000101010101010101010101010101011010010101010101010101010101010101010101010400000000000000000000000000000401010101010101010100000101010101010104040000000000000000000000000000000000000000000000000000010000000000000000000000000000000000
000000000000000001010000000000010100000000000000010000010000000000000000000100010101101010101010101010000000000000000101010100000000000001010000010100000000000000000000000000000000000000000000000000000000000000000000000000000000000000000000000000000000000000000000000000000000000000000000000000000000000000000000000000000100000101010100000000000000000000000000000000000000000000000000000000000000010101010101010101010101010101010101010101010101010101010101010101010101010101010101010101010101010101010100000101010101010101010101010101010101010101010101011010101010101010010111010101010101010101010101010101010101
000000000000010000010100000000010000000000000000010000000000000400000001000104011010101010101010101010000000000000000101010100000000000001010000010100000000000000000000000000000000000000000000000000000000000000000000000000000000000000010101000000000000000000000000000000000000000000000000000000000000000000000000000000010100000000000000000000000000000000000000000000000000000000000000000000000000000101010101000001010101010101010101010101010101010101010101010101010101010101010101010101010101010101010101010101010101010101010101010100000000000000000000000101010101010101000000000000000000000000000000000000000000
000000000000000000000100000001010000000000000000010101010101010101010101010110101010101010101010101010000000000000000101010100000000000001010909010100000000000000000000000000000000000000000000000000000000000000000000000000000000000000010101000000000000000000000000000000000000000000000000000000000000000000000000000000010000000000000000000000000000000000000000000000000000000000000000000000000000000000010100000000000000010101010101010101010101010101010101010101010101010101010101010101010101010101010101010101010101010101010101000000000000000000000000000000000000000000000000000000000000000000000000000000000000
000000000000000000000101010101000000000000000000101010101010101010101010101010101010101010101010101010000000000000000101010100000000000009090909090900000000000000000000000000000000000000000000000000000000000000000000000000000000000000000000000001010100000001000000000001000000000001000000000001000000000001000000000001010000000000000000000000000000000000000000000000000000000000000000000000000000000000000000000000000000000000000000000000000000010101010101010101010101010101010101010101010101010101010101010101010101010101010101000000000000000000000000000000000000000000000000000000000000000000000000000000000000
</map>
<tip>

</tip>
