<map>
00000000000000000000000000000001010101010101010101010101010101010101010101010101010101010101010101010101010101010101010101010101010101010101010101010101010101010101010101010101010101010101010101010101010101010101010101010101010101010101010101010101010101010101010101
00000000000000000000000000000001010000000001000000000000000100000000000000010000000000000001000000000000000100000000000000010000000000000000000101000000000100000000000000010000000000000001000000000000000100000000000000010000000000000001000000000000000000010111110101
00000000000000000000000000000001010000000001000000000000000100000000000000010000000000000001000000000000000100000000000000010000000000000000000101000000000100000000000000010000000000000001000000000000000100000000000000010000000000000001000000000000000000010111110101
00000000000000000000000000000001010000000001000000000000000100000000000000010000000000000001000000000000000100000000000000010000000000000000000101000000000100000000000000010000000000000001000000000000000100000000000000010000000000000001000000000000000000010111110101
00000000000000000000000000000001010000000001000000000000000600000000000000010000000000000001000000000000000100000000000000010000000000000000000101000000000100000000000000060000000000000001000000000000000100000000000000010000000000000001000000000000000000010111110101
00000000000000000000000000010112150101000000000000000000000000000000000000060000000000000001000000000000000100000000000000010000000000000001011215010100000000000000000000000000000000000006000000000000000100000000000000010000000000000001000000000000000101121511110101
00000000000000000000000000000000000000000000000000000000000000000000000000000000000000000006000000000000000600000000000000060000000300000000000000000000000000000000000000000000000000000000000000000000000600000000000000060000000000000006000000000000000000000000000101
01010101010101010101010101010110100101000000000001010100000000000101010000000000010101000000000001010100000000000101010000000000010101010101011010010100000000000101010000000000010101000000000001010100000000000101010000000000010101000000000001010101010101101011110101
00000000000000000000000000000001010000000000000000010000000000000001000000000000000100000000000000010000000000000001000000000000000100000000000101000000000000000001000000000000000100000000000000010000000000000001000000000000000100000000000000010000000000010111110101
00000000000000000000000000000001010000000000000000010000000000000001000000000000000100000000000000010000000000000001000000000000000100000000000101000000000000000001000000000000000100000000000000010000000000000001000000000000000100000000000000010000000000010111110101
00000000000000000000000000000001010000000000000000010000000000000001000000000000000100000000000000010000000000000001000000000000000100000000000101000000000000000001000000000000000100000000000000010000000000000001000000000000000100000000000000010000000000010111110101
00000000000000000000000000000001010000000000000000010000000000000001000000000000000100000000000000010000000000000001000000000000000100000000000101000000000000000001000000000000000100000000000000010000000000000001000000000000000100000000000000010000000000010111110101
00000000000000000000000000000001010000040404040400010004040404040001000404040404000100040404040400010004040404040001000404040404000100000000000101000004040404040001000404040404000100040404040400010004040404040001000404040404000100040404040400010000000000010111110101
00000000000000000000000000000001010101010101010101010101010101010101010101010101010101010101010101010101010101010101010101010101010100000000000101010101010101010101010101010101010101010101010101010101010101010101010101010101010101010101010101010000000000010101010101
</map>
<tip>

</tip>