<map>
000000000000000000000000000000000000000000000000000000000000000000000000000000000000000000000000000000000000000000000000
000000000000000000000000000000000000000000000000000000000000000000000000000000000000000000000000000000000000000000000000
000000000000000000000000000000000000000000000000000000000000000000000000000000000000000000000000000000010000000000000000
000000000000000000000000000000000000000000000000000000000000000000000000000000000000000000000000000000010000000000000000
000000000000000000000000000000000000000000000000000000000000000000000000000000000000000000000000000000010000000000000000
000000000000000000000000000000000000000000000000000000000000000000000000000000000000000000000000000001010000000000000000
000000000000000000000000000000000000000000000000000000000000000000000000000000000000000000000000000000010000000000000000
010101010101010101000000000000000000000000000000000000000000000000000000000000000000000000000000000000010000000000000000
000000000000000001010901000100000000000000000000000000000000000000000000000000000000000000000000000000010000000000000000
000000000000000001010101040101010101030303010101010101000000010101010110001000100010001000100010001000010000000000000000
000000000000000000000001010100000005000000070000000001040404010000000011000000000000000000000000000000010000000000000000
000000000000000000000000000000000005000000000000000001010101010000000011000000000000000000000000000000010000000000000000
000000000000000000000000000000000005040401010100000000000000000000000011041104110411041104110411041104011111111111111111
000000000000000000000000000000000000000000000101010101010101010101111111000000000000000000000000000000000000000000000000
</map>
<tip>

</tip>
