<map>
00000000000000000000010101010100000001010101010101000000000101010101010100000000000000000000000000000000000000000000000001010101010000000000000000000000000000000000000000000000000000000000000000000000000000000000000000000000000000000000000000000000000000000000000000000000000000000000000000000000000000000000000000000000000000000000000000000000000000000000000000000000000000000000000000000000000000000000000000000000000000000000000000000000000000000000
00000000000000000000000000000000000006000000000000000000000100010001000100000000000000000000000000000000000000000101010101060606060000000000000000000000000000000000000000000000000000000000000000000000000000000000000000000000000000000000000000000000000000000000000000000000000000000000000000000000000000000001010101000000000000000000000000000000000000000000000000000000000000000000000000000000000000000000000000000000000000000000000000000000000000000000
00000000000000000000000000000000000000000000000000000000000000000000000000000000000000000000000000000000000000000000000000000000000000000000000000000000000000000000000000000000000000000000000000000000000000000000000000000000000000000000000000000000000000000000000000000000000000000000000000000000000000000001000000000000000000000000000000000000000000000000000000000000000000000000000000000000000000000000000000000000000000000000000000000000000000000000
00000000000000000000000000000000000000000000000000010100000001000100010000000000000000000000000000000000000000000000000000000000000000000000000000000000000000000000000000000000000000000000000000000000000000000000000000000000000000000000000000000000000000000000000000000000000000000000000000000000000000000100000000070101010105000000000000000000000000000000000000000000000000000000000000000000000000000000000000000000000000000000000000000000000000000000
00000000000000000000000410000000000000001000000000060600000101010101010100000000000000000000000000000000000000000101010101010101010101010101000000000000000000000000000000000000000000000000000000000000000000000000000000000000000000000000000000000000000000000000000000000000000000000000070100000000000000010000000000070101010105000000000000000000000000000000000000000000000000000000000000000000000000000000000000000000000000000000000000000000000000000000
01010101010101010101010101010101010101010100010101010101010101010101010101010101010101010101010101010101000000000000000007010101010101010101000000000000000000000000000000000000000000000000000000000000000000000000000000000000000000000000000000000000000000000000000000000000000000000001040404000000000000000000000000000000000000000000000000000000000000000000000000000000000000000000000000000000000000000000000000000000000000000000000000000000000000000000
00000000000000000000000000000001010100000000000000000000000000000000000000000000000000000001010101010101000000000000000007010101010101010101000000000000000000000000000000000000000000000100000000010101010101010101010101010909010101010101010101010101010101010000010101010101010101010101010101010101010101010101010101010404040401040404010101000000011001010101010101040101000000000000000000000000000000000000000000000000000000000000000000000000000000000000
00000000000000000000000000000000000101000000000000000000000000000000000000000000000000000000000000000001000000000101010101010101010101010101000000000000000000000000000000000000000001000100000001010000000000000000000001090909090909090909010101010101010101010000000000000006060606060606000000000000000000000000000000000101010100000000000000000100000000000000000000000001000000000000000000000000000000000000080000000000000000000000000000000000000000000000
00000000000000000000000000000000000101000000000000000000000000000000000000000000000000000000000000000001000000000000000000010101010101010101000000000000000000000000000000000000000001000100010101000000000000000000000001090909090909090909010101010101010101010000000000000000000000000000000000000000000000000000000000000000000000000000000000010000000000000000000000000001000000000000001000000000000014010101010101010101010000000000000000000000000000000000
00000000000000000000000000000000000001000000000000000000000000000000000000000000000000000000000000000001000000000000000000010101010101010101000000000000000000000000000000000000010001000100010100000000000000000000000001090909090909090909010101010101010101010000000000090000000000000000000000000000010101010100000000000000000000000000000001000000000000000000000000000001010105000000000101000000000014000000000000000000010000000000000000000000000000000000
00000000000000000000000000000000000001000000000000000000000000000000000000000000000000000000000000000001000000000000000000000000000000000000000000000000000000000000000000000100011001040100010000000000000000000000000001010101010101010101010101010101010101010101010101010101010101010000000000000001000000000001010000000000000000000000000100000000000000000000000000000000000105000000000101000000000014000000000000000000010101040404010101010101010000000011
00000000000000000000000000000000000001000000000000000000000000000000000000000000000000000000000000000001000000000000000000000001010101010101010101010101010101010101010101010101010101010101010000000000000000000000000000000000000000000000000000000000000000000000000000000000000000010000000400000100000000000000010000000000000008000000010100000000000000000000000000000000000105040404040101040404040414000000000000000000000001010101010606000000000100000100
00000000000000000000000000000000000001000000000000000000000000000000000000000000000000000000000000000001010101010101010101010101010101010101000000000000000000000000000000000000000000000000000000000000000000000000000000000000000000000000000000000000000000000000000000000000000000010101010101010100000000000000010101010101010101010101010000000000000000000000000000000000000101010101010101141414141414000000000000000000000006060606060000000000000001010100
00000000000000000000000000000000000000000000000000000000000000000000000000000000000000000000000000000000000000000000000000000000000000000000000000000000000000000000000000000000000000000000000000000000000000000000000000000000000000000000000000000000000000000000000000000000000000000000000000000000000000000000000000000000000000000000000000000000000000000000000000000000000000000000000000000000000000000000000000000000000000000000000000000000000000000000
</map>
<tip>

</tip>