<map>
000000000000000000000000000000000000000000000000000000000000000000000000000000000000000000070100000000000007010000000701050000000701050000070105000000000000000000000000000000000000000000000000000000000000000000010000000000000000000000000000000000000000000000000000000000000000000000000000000000000000000000000000000000000000000000000000000000000000000000000000000000000000000000000000000000000000000000000000000000000000000000000000000000000000000000000000000000000000000000000000000000000000000000000000000000000000000000000000000000000000000000000000000000000000000000000000000000
000000000000000000000000000000000000000000000000000000000000000000000000000000000000000000070100000000000007010000000701050000000701050000070105000000000000000000000000000000000000000000000000000000000000000000000000000000000000010101010101010101000000000000000000000000000000000004000004000004000004000004000004000004000000000000000000000000000000000000000000000000000000000000000000000000000000000000000000000000000000000000000000000000000000000000000000000000000000000000000000000000000000000000000000000000000012000000000000010101010101010101010101010101010101010101111111111111
000000000000000000000000000000000000000000000101010101010000000000000000000000000101010101010101060606060606060606060606060606010101010101010101010101000000000000000000000000000000000100000000000000000100000000010001000001000000010000000000000000000000000000000000000000000000000000000000000000000000000000000000000000000000000000000000000000000000000000000000000000000000000000000000000000000000000000000000000000000000000000000000000000000000000000000000000000000000000000000000000000000000000000000000000000000000000000000001010000000000000000000000000000000000000007000000000000
000000000000000000000000000000000000000000000111111111010000000000000000000000000000000000000000000000000000000000000000000000000000000000000000000000000000000000000000000000000000000100000001010101000100000000010001000100000000010000000000000000000000000000000000000000000000000001000006000001000006000001000006000001000000000000000000000000000000000000000000000000000000000000000000000000000000000000000000000000000000000000000000000000000000000000000000000000000000000000000000000000000000000000000000000000000000000000000101000000000000000000000000000000000000000007000000000000
000000000000000000000000000000000000000000000111111111010000000000000100000100000000000000000000000000000000000000000000000000000000000000000000000000000000000000000000000000000000000100000001000001000100000000010001010000000000010000000000000000000000000000000000000000000000000000000000000000000000000000000000000000000000000000000000000000000000000000000000000000000000000000000000000000000000000000000000000000000000000000000000000000000000000000000000000000000000000000000000000000000000000000000000000000000000000000010100000000000000000000000000000000000000000007000000000000
000000000000000000000000000000000000000000000111111111010000000000000110100101010001000000000000000000000000000000000000000000000000000000000000000000000400000000000000000000000000000100000001000001000100000000010001000100000000010000000101010000000004010100000000040101000000000001000001000001000001000001000001000001000000000000000000000000000000000000000000000000000000000000000000000010101010100000000000000000000000000000000000000000000000000000000000000000000000000000000000000000000000020202020200000000000000010101010000000000000000000000000000000000000000000007000000000000
000000000000000001010000000000000000000000000111111111010000000000010606060606060606000000000000000000000000000000000000000000000000000000000400000000000100000000000000000000000000000101010001010101000101010001010001000001000000010000000601060000000006010600000000060106000000000000000000000000000000000000000000000000000000000000000000000000000000000000000000000000000000000000000000000000000000000000000000000000000000000000000000000000000000000000000000000000000000000000000000000000000000000000000000000000000000000000000000000000000000000000000000000000000000000007000000000000
000000000000000101010000000000000000000000000606060606060000000000000000000000000000000000000000000000000000000000000000000000000004000000000100000000000100000101010101010101000000000000000000000000000000000000000000000000000000010000000001000000000000010000000000000100000000000001000001000001000001000001000001000001000000000000000000000000000000000000000000000000000000000000101010100000000000000000000000000000000000000000000000000000000000000000000000000000000000000000000000000000000000000000000000000000000000000000000000000000000000000000000000000000000000000007000000000000
000001010101010101010000000000000000000000000000000000000000000000010101010101010111010101010101011001010101100101010110010101010101010101010101010101010100010111111111111101000000000000000000000000000000000000000000000000000000090000000001000000000000010000000000000100000000000000000000000000000000000000000000000000000000000000000000000000000000000000000000000000000000000000000000000000000000000001010101010101010100000000000000000000000000000000000000000000000000000000000000000101010101010101010101010101010100000013010101010101010101010101010101010101010101010101111111111111
010101010101010001010101010101000000010101010101010101010101010000000101010101010000000000000000000000000000000000000000000000000000000000000000000000000000011111111111111101010101010000000101010101010101010101010101010101010101010101010101010101010101010101010101010101010101010101010101010101010101010101010101010101010100000000000000000000000000000010101010100000000000000000000000000000000000000000000000000000000000000000000000000000000000000000000000000000000000000000000000000000000000000000000000000000010100000000000000000000000000000000000000000000000000000007000000000000
111111111111010001011111111105000000071111111111111111110000000000000000010101000000000000000000000000000000000000000000000000000000000000000000000000000000011111111111111101000000000000010100000000000000000000000000000000000000000000000000000000000000000000000000000000000000010000000000000000000000000000000000000000000000000000000000000000000000000000000000000000000000000000000000000000000000000000000000000000000000000000000000000000001010101010101000000000000000000000000000000000000000000000000000000000000114010100000000000000000000000000000000000000000000000007000000000000
111111111111010000011111111105040404071111111111010101110000000000000000000000000001000300000000000000000000000000000000000000000000000000000001000000000000010101010101010101000000000001010000000000000000000000000000000000000000000000000000000000000000000000000000000000000000010004000001000004000001000004000001000004000000000003080000000000001010000000000000000000040404041000000000000000000000000000000000000000000000000000000000000000000000000000000000101010101010000000000000000000000000000000000000000000000000000101000000000000000000000000000000000000000000000007000000000000
111111111111010000000000000000000000000000000000000001110000000001010101010100000100010101010004000100010004000100010001000100040001000104000101040400000000000000000000000000000000000101000000000000000000000000000000000000000000000000000000000000000000000000000000000000000000010000000000000000000000000000000000000000000101010101010101010101010101000000000000000000000000000000000000000000000000000000000000000000000000000000000000000000000000000000000000000000000000000000000000000000000000000000000000000000000000000001010000000000000000000000000000000000000000000007000000000000
111111111111010101010101010101010101010101010101101001110000000000000000000101010000000000000400010001000100040001000400010001000100010000010011111101010101010101010101010101010101010100000000000000000000000000000000000000000000000000000000000000000000000000000000000000000000010404040404040404040404040404040404040404000000000000000000000000000000000000000000000000000000000000000000000000000000000000000000000000000000101010101010101010000000000000000000000000000000001010101010100000000000000000000000000000000000000000010101010101010101010101010101010101010101010101111111111111
</map>
<tip>
arriba, abajo o al medio...
</tip>
