<map>
010101000000000000000000000000000000000404040400010000000004000000000000000000000000000000000101010101010101010101010101010101010101010101010101010101010101010101010101010101010101000000000000000000000000000000000101010101010101000000000000000000000000000000000000000000000000000000000000000000000000
011101000000000000000000000000000000000101010100010000000701050000000404040404040404040404010101010101010101010101010101010101010101060606060606060606060606060601060606060601010101000000000000000000000000000000000000000000000000000000000000000000000000000000000000000000000000000000000000000000000000
011101000000000000000000040400000010000101010104010404040101050000000101010101010101010101010101000001000000010101010101010101010101000000000000000000000000000001000000000001010101000000000000000000000000000000000000000000000000000000000000000000000000000000000000000000000000000000000000000000000000
011101000000000000000000010101010101010101010101010101010101050000000104040404040404010101010101000006000000010101010101010101010101000000000000000000000000000001000000000001010101000100000000000100000000000000000000000000000000000000000000000000000000000000000000000000000000000000000000000000000000
011101040404000000000000010101010101010101010101010101010101050000000106060606060606000000000000000000000000060601010101010101010006000000000000000000000001000001000000000001010101000100010008000100000000000000000000000000000000000100000001000000000000000000000000000000000000000000000000000000000000
011101010101010110100000010101010101010101010101010101010101050000000000000000000000000000000000000000000000000000010101010101000000000000000000000000000001000001000000000001060606000100010001000100000001010101010101010101010104040104040401000000000000000000000000000000000000000000000000000000000000
011111111111110101010000010101010101010101010101010101010101010101010101010101010101010101010101000000000001010100000101010100000101000000000000000000000001000001000000000000000009000100010001000100000001010101000000000000000111111111111111010100000000000000000000000000000000000000000000000000000000
011111111111111111010000010000000000000000000000000000000000010101010101010101010101010101010101000000000001010101000001010000010101000000000000010000000001000008000000000001010101000104010001000100000001010101000000000000000111111111111111110101000000000000000000000000000000000000000000000000000000
010101010101010101010000010000000000000000000000000000000000010101010101010101010101010101010101000000000001010101010000000001010101000000000000010000000001000001000000000101010001000101010401000100000001010101000000000000000111111111111111111101010000000000000000000000000001010101010000000000000000
000000000000000000010000010101010101010101010100000000000000000000000000000000000000000000000001000000000001010101010100000101010101000000000000010000000001000001000000000000010001000001010101000100000001010101000000000000000111111111111111111111010100000000000001010101010000000104040404040400000404
000000000000000000010000011111111111111111110100000000000000000000000000000000000000000000000001040404040401010101010101010101010101040404040404010404040401040401040404040404010001040404040101040100000001010101000000000000000111111111111111111111110101010101000000000000000000000111111111111111111111
000000000000000000010404011111111111111111110100000000000000000000000000000000000000000000000001010101010101010101010101010101010101010101010101010101010101010101010101010101010001111111111101010104040401010101000000000000000101010101010101010101010101010100000000000000000000000101010101010101010101
000000000000000000010101010101010101010101010100000000000000000000000000000000000000000000000000000000000000000000000000000000000000000000000000000000000000000000000000000000000001111111111111110101010101010101000000000000000101010101010101010101010101010000000000000000000000000101010101010101010101
000000000000000000000000000000000000000000000000000000000000000000000000000000000000000000000000000000000000000000000000000000000000000000000000000000000000000000000000000000000001010101010101010101010101010101000000000000000000000000000000000000000000000000000000000000000000000000000000000000000000
</map>
<tip>

</tip>