<map>
0000000000000000000000000101010101010101000000000101010101010101000000000101010101010101000000000000000000000000000000000000010101000001010101000000000001010101010101010000000001010101010101010000000000000000000001010100000101010101000000000000000000000000000000000000000000000000000000000000000000000000000000000000000000000000000000000000000000000000000000000000000000000000
0000000000000000000000000101010101010101000000000101010101010101000000000101010101010101000000000000000000000000000000000001010108010101010101000000000001010101010101010000000001010101010101010000000000000000000101010801010101010101010101010000000000000000000000000000000000000000000000000000000000000000000000000000000000000000000000000000000000000000000000000000000000000000
0000000000000000000000000101000000000101000000000101000000000101000000000101000000000101000000000000010101010100000000000000060601010101000101000000000001010000000001010009090001010000000001010000000000000000000006060601010101000001010101010101010100000000000000000000000000000000000000000000000000000000000000000000000000000000000000000001010101010000000000000000000000000000
0000000000000000000000000101000000000606000000000606000000000101000000000101000000000606000000000001010101010101000000000000010101010100000101000000000001010000000001010009090001010000000001010000000000000000000001010101010000000000000000010101010101000000000000000000000000000000000000000000000000000000000000000000000000000000000000000101010101010101000000000000000000000000
0000000000000000000000000101000000000000000000000000000000000101000000000101000000000000000000000101010000000101000000000000000000000000000606000000000001010000000001010000000001010000000001010000000000000000000000000000000000000000000000000000000101000000000000000000000000000000000000000000000000000000000000000000000000000000000000010901010101010901010000000000000000000000
0000000000000000000000000101000000000000000000000000000000000101000000000606000000000000000000000101000000000101000000000000030900000000000000000000000006060000000001010000000006060000000001010000000000000000000000000000000000000000000000000000000000000000000000000000000000000000000000000000000001010101000000000000000000000000000001010101010101010101010000000000000000000000
0000000000000000000000000606000000000101000000000101000000000101000000000000000000000101000000000101000000000101010000000000010101000000000000000000000000000000000001010000000000000000000001010000000000000000000000000000000000000000000000000000000000000000000000000000000000000000000000000101010101010101010100000000000000000000000001060606060106060101010100000000000000000000
0000000000000000000000000000000000000101000000000101000000000606000000000000000000000101000000000101000000000001010100000001080101010000000101000000000000000000000006060000000000000000000006060000000000000000000000000000000000000000000000000000000000000000000000010101000000000000000001010101010101010101010101000000000000000000000006000000000600000606010101010100000000000000
0000000000000000000000000000000000000101000000000101000000000000000000000101000000000101000000000101000000000001010101010101010606000000000101000000000001010000000000000000000001010000000000000000000000000000000101010101010101010000000000000000000000000000000101010101010100010101010101010101010000000000010101000000010000000000000000000000000000000000010101010101010101000000
0000000000000000000000000101000000000101000000000101000000000000000000000101000000000101000000000101000000000000000101010101010101000000000101000000000001010000000000000000000001010000000000000000000000000000000101010101010101010000000000000000000000000101010101010101010101010101010101010101000000000000000101000000010100000000000000000000000000000000010101010101010101010000
0000000000000000000000000101000000000101000000000101000000000101000000000101000000000101000000000101000000000000000000000000000000000000000101000000000001010000000001010000000001010000000001010000000000000000000101000000000001010000000000000000000000010101010100000001010101010101010101010100000000000000000101000000000101000000000000000000000000000000010101010101010101010000
0000000000000000000000000101000000000101000000000101000000000101000000000101000000000101000000000101000000000000000000000000000000000000000101000000000001010000000001010000000001010000000001010000000000000000000101000000000001010000000000000000000000010100000000000000010101010101010101000000000000000000000101000000000001010101000000000400000000000001010101010101010101010100
0101010101010101010101010101000000000101010101010101000000000101010101010101000000000101010101010101000000000000000000000000000000000000000101010101010101010000000001010101010101010000000001010101010101010101010101000000000001010101010101010101010000000000000000000000000001010101010000000000000000000000010100000000000001010101010101010111111111111101010101010101010101010100
0101010101010101010101010101000000000101010101010101000000000101010101010101000000000101010101010101000000000000000000000000000000000000000101010101010101010000000001010101010101010000000001010101010101010101010101000000000001010101010101010101000000000000000000000000000000000000000000000000000000000101010000000000000000000101010101010101010101010101010000000101010101010000
</map>
<tip>

</tip>