<map>
00000000000101000000000000000000000000000000000000000000000000000000000000000000000000000000000000000000000000000000000000000000000000000000000701000000000000000000000000000000000001000000000000000000010000000000000000000000000000000000000000000000000000000000000000000000000000000000000000000000000000000701
00000000000000010000000000000000000000000000000000000000000000000000000000000000000000000000000000000000000000000000000000000000000000000000000701000000000000000000000000000000000001000000000000000000010000000000000000000000000400000000000000000000000000000000000000000000000000000000000000000000000000000701
00000000000000000100000000140101010101000000000000000000000000000000000000000000000000000000000000000000000000000000000000000000000000000000000701000000000000000000000000000000000001000000000000000000010000000000000000000004040400000000000000000000000000000000000000000000000000000000000000000000000000000701
00000000000000000001000000010000000000010000000000000000000000000000000000001401010101010000000000000000000000000000000000000000000000000000000701000000000000000000000000000000000001000000000000000000010000000000000000000404040404000000000000000000000000000000000000000000000000000000000000000000000000000701
00000000000000000000010000000000000000000100000000001401010101010100000000000100000000000100000000001401010101010000000000140101010101010000000701000000000000000000000000000000000001000000000000000000010000000000000000040404040404040000000000000000000000000000000000000000000000000000000000000000000000000701
00000000000000000000000100000000000000000001000000000100000000000001000000000000000000000001000000000100000000000100000000010000000000000100000701010000000000000000000000000000000001000000000000000000011213010000000404040404040404040400000000000000000000000000000000000000000000000000000000000000010000000701
00000000000000000000000001000000000000000000010000000000000000000000010000000000000000000000010000000000000000000001000000000000000000000001000007010000000000000000000000000000000001000000000000000000090000000000040404040404040404040400080808080800000000000001010101010101010101010111111111111111010000000701
00000000000000000000000000010000000000000000000100000000000000000000000100000000000000000000000100000000000000000000010000000000000000000000010401010000000000000000000000000000000001000000000000000101011010011004040404040404040404040404010101010100000000000001000000000000000000000000000000000000000000000701
00000000000000000000000000000100000000000000000001000000000000000000000001000000000000000000000001000000000000000000000100000000000000000000000101000000000000000000000000010101010001000000000000000000000000000000000000000000000000000000000000000000000000000001000000000000000000000000000000000000000000000701
00000000000000000000000000000004000000000000000000010000000000000000000000010000000000000000000000010000000000000000000001000000000000000000000000000000000000000000000000000000010001000000000000000000000000000000000000000000000000000000000000000000000000000001000000000000000000000000000000000000000000000701
00000000000000000000000000000000010000000000000000000100000000000000000000000100000000000000000000000100000000000000000000010000000000000000000000000000000000000101010100000000010001000000000000000000000000000000000000000000000000000000000000000000000000000000000000000000000000000000000000000000000000000701
00000000000000000000000000000000000100000000000000000001010101010101000000000001010101010101000000000001010101010100000000000101010101010000000000000000000000000000000000000000010001010100000000000000000000000000000000000000000000000000000000000000010112011001010101010101010101010101010101010101010101010101
00000000000000000000000000000000000001000000000000000000000000000701000000000000000000000701000000000000000000070100000000000000000007010000000000000000000000000000000000000000010000000000000000000000000000000000000000000000000000000000000000000000000000000000000000000000000000000000000000000000000000000000
00000000000000000000000000000000000000010101010101010101010101010101010101010101010101010101010101010101010101010101010101010101010101010101010101011000000000000000000000000000010101010110000000000000000000000000000000000000000000000000000000000000000000000000000000000000000000000000000000000000000000000000
</map>
<tip>

</tip>