<map>
000000010000000000000000000000000000000000010101010101010101010101010101010101010101010101010101010101010101010109090909090909090909090909010000000000000000000000000000000001
000000010000000000000000000000000000000000010100000000000000000000000000000000000000000000000000000000010100000109090909090909090909090909010000000000000000000000000000000001
000000010000000000000000000000000000000000010100000000000000000000000000000000000000000000000000000000090800000101010101010101010101010101010000000000000000000000000000000001
000000010101010101010101010101000000000000010100000000000000000000000000000000000000000000000000000000090800000606060606060606060606060606060000000000000000000000000000000001
000000000000000000000000000000000000000000141400000000000000000000000000000000000000000000000000000000090800000000000000000000000000000000000000000000000000000000000000000001
000000000000000000000000000000000000000000000000000004000000000400000000040000000400000004000000040000090800000000000000000000000000000000000000000000000000000000000000000001
000000000000000000000000000000000000010101101001010101010101010101010101010101010101010101010101010101010800000000000000000000000000000000000000000000000000000000000000000001
000000000000000000000000000000000000000000000000000000000000000000000000000000000000000000000000000001010100000000000000000000000000000000000000000000000000000000000000000001
000000000000000000000000000000000000000000000000000000000000000000000000000000000000000000000000000000010101000000000000000000000000000000000000000000000000000000000000000000
000000000000000000000000000000000000000000000000000000000000000000000000000000000000000000000000000000000101010000000101010000000101010000000101010101010101010101010000000011
000000000000000000000000000000000000000000000000000000000000000000000000000000000000000000000000000000000001101010101010101010101010101010101010100100000000000000000000000001
000000000000000000000000000000000000000000000000000000000000000000000000000000000000000000000000000000000000000000000000000000000000000000000000000000000000000000000000000001
000000000000000000000000000000000000000000000000000000000000000000000000000000000000000000000000000000000000000000000000000000000000000000000000000000000000000000000000000001
010000000000000000000000000000000000000000000000000000000000000000000000000000000000000000000000000000000000000000000000000000000000000000000000000000000000000000000000000001
</map>
<tip>

</tip>