<map>
000000000000000000010101010100000000000000000000000000000000000000000000000000000000000000000000000000000000000000000000000000000101010100000000000000000000000000000000000000000000000000000000000001010100010101000101010000000000000000000000001100000000000000000000000000000000000000000000000000000000000001010101010101000000000000000000000000000000000000000000000000000000000014000000000000000000000000000000000000000000001400000000000000000000000000000000000000000000
000000000000000000010606060600000000000000000000000000000000000000000000000000000000000000000000000000000000000000000000000000000100000100000000000000000000000000000000000000000000000000000000000001000100010001000100000000000000000000000000000100000000000000000000000000000000000000000000000000000000000009090909090701000000000000000000000000000000000000001400000000000000000001000000000000000000000000000000000000000000000500000000000000000000000000000000000000000000
000000000000000000010500000000000000000000000000000000000000000000000000000000000000000000000000000000000000000000000000000000000100000100000100000001010101010101010100000000000000000000000000000001010100010001000101010000110000000000000000000100000000000000000000000000000000000000000000000000000000000001010101010101000000000000000000000000000000000000000600000000000000000001000000000000000000000000000000000000000000000500000000000000000000000000000000000000000000
000000000000000000010500000000000000000000000000000000000000000000000000000000000000000000000000000000000000000000000400000000000100000000000100010001060606000000060100000000000000000000000000000001000100010001000000010000010000000000000000000100000000000000000000000000000000000000000000000000000000000000000000000000000000000000000000000000000000000000000000140000140000000101010101010101010101010101010101010101010101010101000000000000000000000000000000000000000000
000000000000000000010500000000000000000000000000000000000000000000000000000000000000000000000000000000000004000000000105000000000000000100000100000000000000000000000100000000000000000000000000000001010100010101000101010000010000000000000000000001000000000000000000000000000000000000000000000000000101010100000000000000000000000000000000000000000000000000000000060000060000000101010101010101010101010101010101010101010101010101000000000000000000000000000000000000000000
000000000000000000010500000000000000000000000000000000000000000000000000000000000000000000000000000000000001010100000600000000000101000100000000010001000000000000000100000000000000000000000000000000000000000000000000000000010000000000000000000001000000000000000000000000000000000000000000000001010100000100000000000000000000000000000000000000000000000000000900000000000000000900060606010606060606060606060606060606060106060601000000000000000000000000000000000000000000
000000000000000000010500000000000000000000000000000101010101010100000000000000040400000000000000000000000112000000000000000000000100000100000100010001000000000400000101010101010101010101010101010101010101010101010101000000010000000000000000000001010101010101000000000000000000000000000000000101000000000100000000000000000000000000000000000000010101010101010101010101010110000100000000010000000000000000000000000000000100000001000000000000000000000000000000000000000000
010101010101000000010404040404040404040404040404000100000606060100000901010101010101010404000000100000000000010101010101010101010101010101010101010101010101010101000000000000000000000000000000000000000000000000000000010101010101010101010111010101000000000001000000000000000000000000000000010100000000000100000000000010000000000000000000000001000000000000000000000000000000000100000000010000000000000000000000000000000100000707000101000000000000000000000000000000000000
010606060606000000010101010101010101010101010101010100000000000100000101010101010101010101010101010001010000010101010100000000000000010000000606000000060000000606000000000000000000000000000000000000000000000000000000010006000000000000000000000001000000000001000000000000000000000000000000010100000000000101010100000101000000000000000000010100000000000715000000000000000000010100000000010000000000000000000000000000000600000001000001000000000000000000000000000000000000
010500000000070100000001010101010100000000000000000000000000000000000000000000000000000001000100010012020000010000060600000000000000000000000000000000000000000000000000000000000000000000000000000000000000000000000000010000000000000000000000000001000001010101010101000000000000000000000001000000000000000100000000000000000000000000010101000000000000000000000000000000000001010100000000060000000000000000000000000000000000000001000009090101010101000011111111111111111111
010404040404070100010000000000000000010101010101010900000000000101010100000000000001010001000000010000000000000000000000000000040000100000000000000701000000000000000000000000000000000000000000000000000000000000000000000000000000000000000000000000000001000000000001000000000000000000000100000000000000000100000000000000000000000001000000000000000000000000000000000000000001010100000000000000000000000001000000000000000100000707000101000100000000000000000000000000000000
010101010101010101010101010101010101010000000000000101010101010000000000040000000001010000000100010101010001000001010100000101010101010101010101010101000000000000000000000000000000000000000000000000000000000000000000010000000000000000000000000001000000000000000000000000000000000000010000000000000000000100000009000000000000000000000000000000071500000000000000000000010101010104000000000000000004040008000404000000010100000003000100000100000000000000000000000000000000
000000000000000000000000000000000000000000000000000000000000000000000000010101010101010101010100000000080000000100000000000000000000000000000000000000000001010101010101010101010101010101010101010101010101010101010100010000000004000000000000040001000000000000000000000000000000000001000000000000000000000101010101010101010101010101010000010101010100010101010001010101010101010101010101010101010101010101010101010101010101010101010101010100000000000000000000000000000000
000000000000000000000000000000000000000000000000000000000000000000000000000000000000000000000001010101010101010101010101010101000101000101000001010101010101000000000000000000000000000000000000000000000000000000000000010101010101010101010101010101010101010000000001010101010101010101000000000000000000000000000000000000000000000000000000000000000000000000000000000000000000000000000000000000000000000000000000000000000000000000000000000000000000000000000000000000000000
</map>
<tip>
HaHa trolld
</tip>