<map>
00000000000000000000000000000000000000000000000000000000000000000000000000000000000000000000000000000000000000000000000000000000000000000000
00010109090909090909090808080808080909090909080808080808090909090909090808080808000000000000000000000000000000000000000000000000000000000000
00010101090909090909090808080808080909090909080808080808090909090909090808080808000000000000000000000000000000000000000000000000000000000000
00010101010909090909090808080808080909090909080808080808060606060606090808080808000000000000000000000000000000000000000011111111000000000000
00010101010109090909090808080808080909090909080808080808090909090909060606060608000000000000000000000000000000000000000011111111111100000000
00010101010101090909090808080808080909090909080808080808090909090909090808080808000000000000000000000000000000000000000000000007010100000000
00010101010101101010090808080808080909090909080808080801010101010109090808080808000000000000000000000000000000000000000000000007010100000000
00010101010101010101010808080808080909090909080808010101010101010101010108080808000000000000000000000000000100000000000000000007010100000000
00010101010101010101010108080808080909090909080801010101010101010101010101080808000000000000000000000000000101010000000000000007010100000000
00010101010101010101010101080808080909090909080101010101010101010101010101080808000000000000000000000000000101010100000000000007010100000000
00010101010101010101010101010808080907090909010101010101010101010101010101080808000000000000000000000000010101010110100000000007010100000000
00010101010101010101010101010108080409090901010101010101010101010101010101080808000000000000000000000001010101010101010400000007010100000000
00010101010101010101010101010101010101010101010101010101010101010101010101010404040404000000000000000101010101010101010104040401010100000000
00010101010101010101010101010101010101010101010101010101010101010101010101010101010101010101010101010101010101010101010101010101010100000000
</map>
<tip>
muere :)
</tip>
