<map>
010101010000000101010101010101010101010101010101010101010101010101010101010101010101010101010101010101010101010101010101010101010101010101010101010101010101
010101010100000001010101010101010101010101010101010101010101010101010101010101010101010101010000000101010101010101010101010101010101010101010101010101010101
010101010101000000010101010101010101010101010101010101010101010101010101010101010101010101000001000101010101010101010101010101010101010101010101010101010101
010101010101010000000101010101010101010101010101010101010101010101010101010101010101010100000101000101010101010101010101010101010101010101010101010101010101
010101010101010100000000000000000000000101010100000000000000000001010101010101010101010000010101000101010101010101010101010101010101010101010101010101010101
010101010101010101010101010101010101000101010100010101010101010000000101010101010101000001010101000101010101010101010101010101010101000000000101010101010101
010101010101010101010101010101010101000101010100010101010101010101000000000000000000000101010101000101010101010101010101010101010000000101000101010101010101
010101010101010101010101010101010101000101010000010101010101010101010101010101010101010101010101000101010101010101010101010100000001010101000101000001010101
010101010101010101010101010101010101000101010010010101010101010101010101010101010101010101010101000101010101010101010101000000010101010101000101001101010101
010101010101010101010101010101010101000101010001010101010101010101010101010101010101010101010101000101010101010100000000000101010101010101000101000101010101
010101010101010101010101010101010101000101010001010101010101010101010101010101010101010101010101000101010101010000010101010101010101010101000101000101010101
010101010101010101010101010101010101000101010001010101010101010101010101010101010101010101010101000101010101000001010101010101010101010101000101000101010101
010101010101010101010101010101010101000000000001010101010101010101010101010101010101010101010101000000000000000101010101010101010101010101000000000101010101
010101010101010101010101010101010101010101011001010101010101010101010101010101010101010101010101010101010101010101010101010101010101010101010101100101010101
</map>
<tip>

</tip>