<map>
000000000000000000000000000000000000000000000000000000000000000000000000000000000000000000000000000000000000000000000000000000000000000000000000000000000000000000000000000000000000000000000000000000000000
000000000000000000000000000000000000000000000000000000000000000000000000000000000000000000000000000000000000000000000000000000000000000000000000000000000000000000000000000000000000000000000000000000000000
000000000000000000000000000000000000000000000000000000000000000000000000000000000000000000000000000000000000000000000000000000000000000000000000000000000000000000000000000000000000000000000000000000000000
000000000000000000000000000000000000000000000000000000000000000000000000000000000000000000000000000000000000000000000000000000000000000000000000000000000000000000000000000000000000010000000000000000000000
000000000000000000000000000000000000000000000000000000000000000000000000000000000000000000000000000000000000000000000000000000000000000000000000000000000000000000000000000000010000010100000000000000000000
000000000000000000000000000000000000000000010100000000000000000000000000000000000000000000000000000000000000000000000000000000000000000000000000000000000000000000000000000100010001010101010101000000000000
000000000000000000000000000000000000000007110100000000000000000000000000000000000000000000000000000000000000000000000000000000000000000000000000000000000000000000000101000100010001010101010101010000000000
000000000000000000000000000000000000000007110101000000000000000000000000000000000000000000000000000000000000000000000000000000000000000000000000000000000000000000010101010100010001010101010101000000000000
000000000000000000000000000007000012000007111101010000000000000000000000000000000000000000000000000000000000000000000000000100010100010001000100010100000100000100010101010101000000010101010101000000000000
000000000000001000100000000404000012101001111111010108001010101004040404030000000000000000000000000000000000000000000000000000000000000000000000000000000000000000000000000000000000000101010101000000111111
010101010101010101010101010101010101010101111111110101010101010101010101010101010101010000000000000000000000000200000001000011111111000000000000000000000000001111111111000000000000000101010100000000000000
000000000000000000000000000000000000000000000000000000000000000000000000000000000000000000000000000000000000000000000000000000000000000000000000000000000000001111111111000000000000000000010100000000000000
000000000000000000000000000000000000000000000000000000000000000000000000000000000000000000010101000000000000000000010000000000000000000000000000000000000000000000000000000000000000000000000000000000000000
000000000000000000000000000000000000000000000000000000000000000000000000000000000000000000000000000100010001000100000000000000000000000000000000000000000000000000000000000000000000000000000000000000000000
</map>
<tip>
Si lleigeixes això ja has passat el nivell
</tip>