<map>
00000000000000000000000000000000000000000000000000000000000000000000000000000000000000000000000000000000
00000000000000000000000000000000000000000100000000000000000000000000000000000000000000000000000000000000
00000000000000000000000000000000000001010100000000000000000000000000000000000000000000000000000000000000
00000000000000000000000000000001000000000000000000000000000000000000000000000000000000000000000011111111
00000000000000000000000000010101010001010000000000000000000000000000000000001004040400000000000000000011
00000000000000000000000100010000010100010100000000000000000000000000000000100101010111111111111111111111
00000000000000000000000000000001010000010100000000010101010101010101010101010100000000000000000000000000
00000000000000000001000000000001010000000101010101010000000000000000000000000000000000000000000000000000
00000000000000000000010100000101000000000000000000000000000000000000000000000000000000000000000000000000
01010101010101010101010101010100010100000000000000000000000000000000000000000000000000000000000000000000
00000000000000000000000000010101010101010100000000000000000000000000000000000000000000000000000000000000
00000000000000000001010101010101010101000100000000000000000000000000000000000000000000000000000000000000
00000000000000000001000101010001010000000100000000000000000000000000000000000000000000000000000000000000
00000000000000000001010101010000000000000000000000000000000000000000000000000000000000000000000000000000
</map>
<tip>

</tip>