<map>
0101010000010000010101010101010101010101010002040404040404010101010100000000000101010101000001000000000000000000000000000000000000000000000000000000000000000000000000000000000000000000000000000000000000
0101010100010000000101010600000000000600010000010404040101010000000101010101010100000101000101010000000000000000000000000000000000000000000000000000000000000000000000000000000000000000000000000000000000
0101010100010000000101000000000000000000000101010101010103000000000000000600000000000001010100000100000000000000000000000000000000000000000000000000000000000000000000000000000000000000000101010100000000
0101010100010100000100000000010101010100000000000000000003000000000000000000000000000000000000000101010100000000000000000000000000000000000000000000000000000000010100000000000000000000010106060101000000
0101010100010100000000010101040404010100000100000000000003000000000001000000010001010100000000000000000101000000000000000000000000000000000000000000000000000101010101010000000000000001010600000601010000
0101010100000000000001060601010404010101010001010100010103000000000101010101010101010100000101010000000001010100000000000000000000000000000000000000000000000111111111110100000000000106060000000006010100
0101010101010000000001060606010104010001000001010000000101010100100106060606060601010100010404040101010000000100000000000000000000000000000000000101010000010111111101110101000000010100000000000000060100
0101010101000000000001010606060104010000000000000010040000010101010100000000000001010000010101010000000100000101000000000000000000000000000001010100000101011111111111111101000000010001010000000001000100
0001010101010101010000010106060601010001000000000101010101000100010104000000000101000001010000010100000100000001010101010101000000000001010100000000000000010101010101010101010101000000011111110001000100
0001010101000000010100060100000001000001010000010100000001010100000101000001000001000101000001010101000001010000000000000001000001010101000000000000000300000000000000060606000000000100010101010000000100
0001010101000000000100000101000000010000010000000000000000010100000000000000000000000100000101000001000000010100000000000000010101000000000000000000000101010101010100000000000200000100000101000000110100
0000010101000101000000000000000000000001010410000000000000000100000606000004000104000100000100000001010000000001010101000000000000000000000000000000010001011111110101010101000000100101000000000000010000
0000010101010100010000000000101000000100010101000400000000010104040101040101010001010100000101010101000000000000000001000101010000000000000000000000010000010101111101040404010101010001010000001010010000
0000010101010000000101010101010101010000000001010101010101010101010101010000000000000000000000000000000000000000000000010404040101010101010101010101010000000001010101010101000000000000010101010101010000
</map>
<tip>
MAZE
</tip>