<map>
0000000000000000000000000000000000000000000000000000000000000000000000000000000000000000000000000000000000000000000000000000000000000000000000000000000000000000000000000000000000000000000000000000000000000000000000000000000000000000000000000000000000000000000000000000000000000000000000000000
0000000000000000000000000000000000000000000000000000000000000000000000000000000000000000000000000000000000000000000000000000000000000000000000000000000000000000000000000000000000000000000000000000000000000000000000000000000000000000000000000000000000000000000000000000000000000000000000000000
0000000000000000000000000000000000000000000000000000000000000000000000000000000000000000000000000000000000000000000000000000000000000000150000000000000000000000000000000000000000000000000000000000000000000000000000000000000000000000000000000000000000000000000000000000000000000000000000000000
0000000000000000000000000000000000000000000000000000000000000000000000000000000000000000000000040000000400040000000000000000000000000000000000000000000000000000000000000000000000000000000000000000000000000000000000000000000000000000000000000000000000000000000000000000000000000000000000000000
0000000000000000000000000000000000000000000000000000000000000000000001010100000000000000000001010101010101010101010000000000000000000000000000040004000000000000000000000000000000000000000000000000000000000000000101010001010000000000000000000000000000000000000000000000000000000000000000000000
0000000000000000000000000000000000000000000000000000000101010101010001000001000000000000000001010101010000000000010000000000000000000001010100010501000000000000000000000000000000000000000000000000000000010101010101010001010000000000000000010101010000000000000000000000000000000000000000000000
0000000000000000000000000000000000000000000000000000000100000000010001000000010000000000000001010101010000000000010000000000000000000101000100010701000000000000000000000000000000000000000000000000000001000000000000010001010000000000000001010100010100000000000000000000000000000000000000000000
0000000000000000000000000000000000000000000000000000100100000000010001000000000100000000000901010101010000010101010000000000000000010000000100010501000000080808080000000000000000000000000000000000000100000000000000010001010000000000000100010101010101000000000000000000000000000000000000000000
0000000000000000000000000000000000000000000101010101010100000000010001000000000000010101010101010101010000010404040000000000000001000000000100010401000000010101010101010100000000000000000000000000010000000000000000010001010000000000010000000001010101010000121200000000000000000000000000000000
0000000000000000000001000000000000000000000000000000000000000000010001010000000001000000000000000000000000010101010100000000000100000000000100010101000001000000000000000001000000000000000000000001000000000000000000010000000000000000010000000001010101010100000000000000000000000000000000000000
0000000000000001010101000000000010101010100000000000000000000000010000000000000100000000000000000000000000000000000100000000010000000000000100000000000100000000000000000000010000000000000000000100000000000000000000000100000000000001000000000001010101010101010101000000000000000000000011111111
0000000000010101010101010101010101010101010000000000000000000000010000000000010000000000000000000000000000000000000101010101000000000000000101010101010000000000000000000000000100000000000000010000000000000000000000000001000000000100000000000000010001000000000000000000000000000000000001010101
0000000000010000000000000000000000000000000000000000000000000000010101010101000000000000000000000000000000000000000000000000000000000000000000000000000000000000000000000000000001010101010101000000000000000000000000000000010101010000000000000001010001000000000000000000000000000000000000000000
0101010101010000000000000000000000000000000000000000000000000000000000000000000000000000000000000000000000000000000000000000000000000000000000000000000000000000000000000000000000000000000000000000000000000000000000000000000000000000000000000000000101000000000000000000000000000000000000000000
</map>
<tip>

</tip>