<map>
010100000000000000000001040404040404040404040404040404040401010000000000000000000000000000010000000000000000000000000000000000000000000000000000000000000000000000000000000000000000
010100000000000000000001010101010101010101010101010101010101010000000000000000000000000000010000000000000000000000000000000000000000000000000000000000000000000000000000000000000000
010100000000000000000001010101010101010101010101010101010101010000000000000000000000000000000000000000000000000000000000000000000000000000000000000000000000000000000000000000000000
010100000000000000000001010101010101010101010101010101010101010000000000000000000000000001000001000000000000000001000000000200000000000000000000000000000000000000000000000000000000
010101010101010101000001010101010101010101000000000000000000010000000000000000000000000001000001000000000000000001000000000000000000000000000000000000000000000000000000000000000000
010101010101010101000001010101010101010101000000000000000000010000000000000000000000000000000000000000000000000001000000000000000000000000000000000000000000000000000000000000000000
010101010101010101000001010101010101010101000001010101010000010101010101010101010100000100000000000101010101010101010101010101010100000000000000000000000000000000000000000000000000
010101010101010101000000000000000000000000000001010101010000000000000000000000000000000100000000000101010101010101010101010101010101000000000000000000000000000000000000000000000000
010101010101010101000000000000000000000000000001010101010000000000000000000003000000000000000000000000000000000001000000000000010001010000000000040400000404000004040000000000000000
010101010101010101010101010101010101010101000001010101010000010101010101010101010100010000000000000000000000000001000000000000010000010101010101111101011111010111110101010101010101
010101010101010101010101010101010101010101000000000000000000010000000000000000000000010000000000000000000000000001000000000000010000000101080801111101011111010111110108080808080801
010101010101010101010101010101010101010101000000000000000000010000000000000000000000010000000000000000000000000001000000000000010000000001080801111101011111010111110108080808080801
010101010101010101010101010101010101010101010101010101010101010000000000000000000000010000000000000000000000000001000000000000010000000001080801111101011111010111110108080808080801
010101010101010101010101010101010101010101010101010101010101010000000000000000000000010000000000000000000000000001000000000000010000000001080801111101011111010111110108080808080801
</map>
<tip>
protip xd
</tip>
